AAAAGAAAAAAAAAAGAAGGCGAGATGGAGGAAGCAAAGTAAGAAGAAAGACAGACACGTATATAAGAGTGTCGGAGGGGGGAGAGCAACAAGTCGGGTGGTATTGGTGATGGTAGGGAGGGAGGTAAGGGAGGGGAGGAGGAGGTGGAAG	length=151

TCCATTCTCTGNNNGNNNNNNTGAGTAAACCTGAATCTTTGGAGTACGCTGGATAGCCTCCAGTANAGAA	Seq Percent=70%

TCCATTCTCTGNNNGNNNNNNTGAGTAAACCTGAATCTTTGGAGTACGCTGGATAGCCTCCAGGANAGAA	Seq Percent=70%

CACCGGCTAGANNNGNNNNNNTCGTGTAGGGAAAGAGTGTACATCGGTGTAGATCTCGGTGGTCGNCGTATNNTTAAAAAAAAAAAAAAAACAAATAAAACAAAAAAACAAAAACACACAAAAAAAAAATAAGAAGAAATAAAGACATACA	Seq Percent=151%

TGGTTCACACCNNNANNNNNNATGGGGGCGTCAGCAGAGGGGGCAGAGATGATGACCCTTTTGGNNGCCGCNNGCAAATGAGACACAGCCTTCTCCATGGTGGGGAAGACGCCAGTGGACACAACGACGTACTCAGCGCCAGCATCGCCC	Seq Percent=150%

TCCATTCTCTGCTGNATGACGTGAGTAAACCTGAATCTTTGGAGTACGCTGGATAGCCTCCAGGCCAGAAT	Seq Percent=71%

TCCATTCTCTGCTGGATGACGTGAGTAAACCTGAATCTTTGGAGTACGCTGGATAGCCTCCAGGCCATAA	Seq Percent=70%

TCAATTCTATGNNNNGTNACATGAGTAAACAAGAATCTTCGAAGTAAACTGGAAAGGCTCCAAGCANAAAANAGAGAGTAGCGCGAGCACAGCTAAGGCCACGGAGCGAGACATCTCGGACCA	Seq Percent=123%

TCCATTCTCTGNNNGNNGACGTGAGTAAACCTGAATCTTTGGAGTACGCTGGATAGCCTCCGGGCCAGA	Seq Percent=69%

TCCATTCTCTGNNGGNNNNNNTTATTAAACCTGAATCTTTTGAGTACTCTTTATAGCCTCCATGCNAGAAAGNTAGAGTAGCGCGAGCACAGCGAAGGCCCC	Seq Percent=102%

GATATGCTAGATCGGGAAGAGTAGTGTAGGGAAAGAGTGTACATCGGAGTAGATGTCGGTGGACGCGAGAGCATTAAAAAAAAAAAAAAAAAAAAGGAAGAAAAAAAAGAAAAAAGAAAAAAAGAAAAAAAGAAAAAAAAGAAGAAGAAAG	Seq Percent=151%

TCCATTCTCTGCTGGNNNANNTGAGTAAACCTGAATCTTTGGAGTACGCTGGATAGCCTCCAGGCCAGAAAG	Seq Percent=72%

TCCATTCTCTGCTGNATGACGTTATTNAACCTGAAATAGGAAGAGCGTCTNTAAGGGAACGATTGTACANCGGTGAAGAGAAAGGAGTTCGCCTTGTGGTTACCCGAAAAAAAAGAAAGACTAGGAAGGAAGCCACGAAAGAAACTATCAN	Seq Percent=151%

TCCATTCTCTGCTGGATGACGTTATTTAACCTGAGATAGGAAGAGCGTCTTTAAGGGAACGATTGTACATCGGTGAAGAGAAAGGGGTTCGCCTTGTGGTTACCCAAAAAAAAAAAGAAGCCAAGAAAAAAGCTGCAAAAAAGACTGCTAN	Seq Percent=151%

TCCATTCCCTGGTGNNTTACTTGAGTAAACCTGAATCTTTGGAGTACGCTGGATAGCCTCCAGGCCAGAAAGAGAGAGTAGCGCGAGCAAAGCTAAGGCCACGGAGCGAGACATCTCGGCACGAATGCTGTCAGCTTCAGGAATGCCT	Seq Percent=148%

TCCATTCTCTGCTGGATGACGTTATTAAACCTGAATCTTTTGAGTACTCTTTATAGCCTCCATGCCTGAAAG	Seq Percent=72%

TGGTTCACACCNNNGNNNNNNATGGGGGCGTCAGCAAGGGGGC	Seq Percent=43%

TCCATTCTCTGCTGGATGACGTGAGTAAACCTGAATCTTTGGAGTACGCTGGATAGCCTCCAGGCAAGAA	Seq Percent=70%

CGTTCTGTGTTCACCNNNANNTCCCCTTGTCTCATCTGCTTTACGGTGAAGTCGTTGATGAGTTTTTTGTTTTGCTCGTTGAGGCCGCAGTGCAGGGTCACTCAGGTCGC	Seq Percent=110%

GGATCTCGACGCTCTNNNNNNCAGATTCGCCTTCGCCTAGAGTTCTCGTTTGAATATTTGCTACTAGTACCA	Seq Percent=72%

CGNGNTGTGTCACCNGGAAGGCCCCNNGTCTCNNCTGCTTGANNNTGAAGNNGTTGATGAGGNGGTGGNNGTGCTCGTTNNNGCCGCNGTGCAAGGCAGATCGGAANNGCGTCGNGTAGGGNNAGAGTGTACNNNGGTGTNGATCTCGGNN	Seq Percent=151%

TCCATTCTCNGNNNNNNNNNNNGAGTAAACCTGAATCTTTGGAGTACGCTGGATAGCCTCCAGNNNNNAANNNGAGAGTAGCGCGAGCACAGCTAAGGCCACGGAGCGAGACATCTCGGCCCGAATGCTGTCAGCTTCAGGAATCGCGAT	Seq Percent=150%

TCCATTCTCNGNNNNNNNNNNNGAGTAAACCTGAATCTTTGGAGTACGCTGGATAGCCTCCAGNNNNNAANNNG	Seq Percent=74%

TCCATTCTCTGNNNGNNNNNNTGAGTAAACCTGAATCTTTGGAGTACGCTGGATAGCCTCCAGGANAGAAANNTCGGAAGAGGGTCGTGTAGGGAAAGAGTGAACATAGGTGTAGAACTCGGTGGTAGCCGTATCAATAAAAAAAAAAAAA	Seq Percent=151%

TCCATTCTCTGNNGGNNNNNNTGAGTAAACCTGAATCAGAAGATCGGAAGAGCGTCGTATGGGGANAGAGTAGACATCGGTGTAAATATCGGAGGTCGCAGTATCATAAAAAAAAAAAAAAAAAAAAAAAAAAAAAAAAAAAAACAAAAAG	Seq Percent=151%

TCCATTCTCTGATGGNNNNNNTGAGTAAACCTGAATCTTTGGAGTACGCTGGATAGCCTCCAGGCNATAA	Seq Percent=70%

CGGGCNGTGNNNNNNNNGAAGGCNCCTTGTCTCATCTGCTTNNNNGTGAAGTCGTTGATGAGGNGGTNNNNNTGCTCGTTGAGGCCGCAGTGCAGGGTCACGCAGTCGCTGTGGAAGAGCNGGTCCTGCAGGGTGCTGACACGCTGNNGN	Seq Percent=150%

TCCATTCTCTGNNGGNNNNNNTGAGTAAACCTGAATCTTTGGAGTACGCTGGATAGCCTCCAGGCNAGAAANNGAGAGTAGCGCGAGCACAGCTAAGGCCACGGAGCGAGA	Seq Percent=111%

CGGGCTGTGTTCACCAGGAAGGCCCCTTGTCCCATCTGCTTGACGGTGAAGTCGTTGATGAGGTGGTGGTTGTGCTCGTTGAGGCCGCAGTGCAGGGTCACGCAGTCGCTGTGGAAGAGCAGGTCCTGCAGGGTGCTGACACGCTGCAGC	Seq Percent=150%

CGGGCTGTGTTCANNNGGAAGGCCCCTTGTCTCATCTGCTTGACGGCGAAGTCGTTGATGAGGTGGTGGTTGTGCTCGTTGAGGCCGCAGTGCAGGGTCACGCAGTCGCTGTGGAAGAGCAGGTCCTGCAGGGTGCTGACACGCTGCAGC	Seq Percent=150%

TCCATTCTCTGNNNGNNNNNNGGAGTAAACCTGAATCTTTGGAGTACGCTGGATAGCCTCCAGGNNAGAAANNGAGAGTAGCGCGGGCAC	Seq Percent=90%

CGGGCTGCGTTGAACAGGANNGCCCCTTGTCTCATCTGCTTGACGGTGAAGTCGTTGATGAGGTGNGGGTGGNGCTCGTTGAGGCCGCAGTGCAGGGTCACGCAGTCGCTGTGGAAGAGCAGGTCCTGCAGGGTGCTGACACGCTGCAGC	Seq Percent=150%

CGGGCTGCGTTGAAANGGANNGCCCCTTGTCTCATCTGCTTGACGGTGAAGTCGTTGATGAGGTGNGGGTAGNGCTCGTTGAGGCCGCAGTGCAGGGTCACGCAGTCGCTGTGGAAGAGCAGGTCCTGCAGGGTGCTGACACGCTGCAGC	Seq Percent=150%

CGGGCTGCGTTGAAANGNNNNNCCCCTTGTCTCATCTGCTTGACGGTGAAGTCGTTGATGAGGTNNGGGTGGNGCTCGTTGAGGCCGCAGTGCAGGGTCACGCAGTCGCTGTGGAAGAGCAGGTCCTGCAGGGTGCTGACACGCTGCAGC	Seq Percent=150%

TGGTTCACACCGATGACGAAAATGGGGGCATCAGCAGAGGGGGCAGAGATGATGACCCTTTTGGAGCGCCAAAGCAAATGAGCCCCAGCCTTCTCCATGGTGGTGAAGACGCCAGTGGACTCCACGACGTACTCAGCGCCAGCATCGCCC	Seq Percent=150%

TGGATCAAAACCATGNNNNNNATGGGGGCGTCAGCAGAGGGGGCAGAGATGATGACCCTTTTGGANGACGGCAGCAAATGAGCCCCAGCCTTCTCCATGGTGGTGAAGACGCCAGTGGACTCCACGACGTACTCAGCGCCAGCATCGACA	Seq Percent=150%

TCCATTCTCTGCTGGATGACGTGAGTAAACATGAATCTTTGGAGTACGCTGGATAGCTTCCAGGCCAGAA	Seq Percent=70%

TTCAATCTCCTCTTGGGTTGGATCTCGACGCTNTACATTACTCACACTCCAGAAGTATATACACCGTGCNAAACT	Seq Percent=75%

TCCATTCTCTGCTGGATGACGTGAGTAAACCTGAATCTTTGGAGTACGCTGGATAGCCTCCAGGCCAGAAC	Seq Percent=71%

TGGTTCACACCCATGACGAACATGGGGGCGTCAGCAGAGGGGGCAGAGATGATGACCCTTTTGGCTCCCCCCTGCAAATGAGCCCCAGCCTTCTCCATGGTGGTGAAGACGCCAGTGGACTCCACGACGTACTCAGCGCCAGCATCGCCC	Seq Percent=150%

TCCATTCTCTGNNGGNNNNNNTGAGTAAACCTGAATCTTTGGAGTACGCTGGATAGCCTCCAGGNNAGAAANNGAGAGTAGCGCGAGCACAGCTAAGGCCACGGAGCGAGACATCTCGGCCCGAATGCAGC	Seq Percent=131%

TCCATTCTCTGCTGNATGACGTGAGTAAACCTNNATCTTTGGAGTACGCTGGATAGCCTCCAGGCCAGANAGAGAGAGTNGCGCGAGCACAGCTAAGGCCACGGAGCGAGACATCTCGGCCCNAATGCTGTCNGCTTCGANATCGGAAGAN	Seq Percent=151%

TCCATTCTCTGNNNGNNNNNNTGAGTAAACCTGAATCTTTGGAGTACGCTGGATAGCCTCCAAGNNAGAAG	Seq Percent=71%

TCCATTCTCTGATGGATGACGTGAGTAAACCTNAATCTTTGGAGTACGCTGGATAGCCTCCAGGACAGAN	Seq Percent=70%

CAGGAATTCAATCTTCTCCTGGTCTGTGGAACACTTCTTCAAAGTCTATACAAAATAAAAACAAGTCAGGAATCAGTATAGCAGACATTTCTGCGAGCTCAGAGGGTTAATGGAGATTGTTCTGTTTGTTCTGTAATATCTACCCTGAAAG	Seq Percent=151%

CGGGCTGTGTTNNNCNNNNNNGCCCCTTGTCTCATCTGCTTGACGGTGAAGTCGTTGATGAGGTNNTGGTTNNGCTCGTTGAGGCCGCAGTGCAGGGTCACGCAGTCGCTGTGGAAGAGCAGGTCCTGCAGGGTGCTGACACGCTGCAGC	Seq Percent=150%

TCCATTCTCTGNNGGNNNNCGTGAGTAAACCTGAATCTTTGGAGTACGCTGGATAGCCTCCAGGACACAA	Seq Percent=70%

TCCATTCTCTGCTGGNNGANNTGAGTAAACCTGAATCTTTGGAGTACGCTGGATAGCCTCCAGGCAAGAAA	Seq Percent=71%

TCAATTCTCTGNNNGNNNNNNTGAGTAAACCTGAATCTTTGGAGTACGCTGGATAGCCTCCAGGNNAGAA	Seq Percent=70%

TCCATTCTCTGCTGGATGACGTGAGTAAACCTGAATCTTTGG	Seq Percent=42%

TTCGGGAAGAGAGACGAGAAGGGAAAGAGTGTAATGGTGG	Seq Percent=40%

TCCATTCTCTGCTGGATGACGTGAGTAAACCTGAATCTTTGGAGTACGCTGGACACCCTCCAGGACAGAAA	Seq Percent=71%

TCAATTCTCAGAAGGAAGAANTGAGTAAACCTGAATCTTTGGAGTACGCTGGATAGCCTCCAGGAAAGAAAGAGAGAGTAGCGCGAGCAGAGCTAAGGCAACGGAGCGAGACATCTCGGCCCGAATGCTGTCAGCTTCAGGTATGCA	Seq Percent=147%

TCCATTCTCTGNNNNNNNNNNTGAGTAAACCTGAATCCTTGGAGTACGCTGGATAGCCACCAGGNNCGAA	Seq Percent=70%

TCCATTCTCTGCTNNNNGACGTGAGTAAACCTGAATCTTTGGAGTACGCTGGATAGCCTCCAGGCTAGAAAGAGAGAGTAGCGCGAGCACAGCTAAGGCCACGGAGCGAGACATCTCGGCCCGAATGCTGTCAGCC	Seq Percent=136%

TCCATTCTCTGCTGGATGACGTGAGTAAACCTGAATCTTTGGAGTACGCTGGATAGCCTCCAAGTC	Seq Percent=66%

TGGTTCACACCAAAGAAAAAAATGGGGGCATCAGCAGAGGAGGCAGAGATGATGACCCTTTTGGAACCCCCAAGCAAATGAGCCCCAGCCTTCTCCATGGTGGTGAAGACGCCAGTGGACTCCACGACGTACTCAGCGCCAGCATCGCCC	Seq Percent=150%

TGGTTCACACCCATGNCNNNNATGGGGGCGTCAGCAGAGGGGGCAGAGATGATGACCCTTTTGGNNCCCCCNNGCAAATG	Seq Percent=80%

TCCATTCTCNGNNNNNNNNNNNGAGTAAACCTGAATCTTTGGAGTACGCTGGATAGCCTCCGGGNNNNAANNNGAGAGTAGCGCGAGCACAGCTAAGGCCACGGAGCGAGACATCTCGGCCCGAATGCTGTCAGCTTCAGGAATGCCCCAG	Seq Percent=151%

ATCACCGTGCGGAACAGCTNNGTCTTGTACTTCGGATGGCGAGTCAGGCTGCGCAGCTCGTGGAAGCCATGCGCGAACTGGCACTTTTCGCCGTACTTGCACGTGCCGCTCTCCTCGAAGGGCCGGCACAGCTCGGTCTTGTAGCGCGTGG	Seq Percent=151%

CGGGCTGTGTTNNAANNNNNNGCCCCTTGTCTCATCTGCTTGACGGTGAAGTCGTTGATGAGGTGNTGGTTNNGCTCGTTGAGGCCGCAGTGCAGGGTCACGCAGTCGCTGTGGAAGAGCAGGTCCTGCAGGGTGCTGACACGCTGCAGC	Seq Percent=150%

TGGTCACACCCATGACTAACATGGGGGCGTCAGCAGAGGGGGCAGAGATGATGACCCTTTTGGCTCCCCCCTGCAAATGAGCCCCAGCCTTCTCCATGGTGGTGAAGACGCTAGTGGACTCCACGACGTACTCAGCGCCAGCATCGCCCCA	Seq Percent=151%

CAGGAATTCAATCTTCTCCTGGTCTGTGGAACCCTTCTTCAAAGTCTTCACTGCTACTTTGATTTCTCCACTTCCAACTCCTAAGATGTCCACTGCTGTTCCTTCATACACTTCTCCAAAGGCTCCACTTCCCAGCAAGAGACGCAGAGT	Seq Percent=150%

CGGGCTGTGTTCACCAGGAAGGCCCCTTGTCTCATCTGCTAGACGGTGAAGTCGTTGATGAGGTGGTGGTGTGCTCGTTGAGGCAGCAGAGCATT	Seq Percent=95%

TCCATTCTCTGCTGGNNGNNNTGAGTAAACCTGAATCTTTGGAGTACGCTGGATAGCCTCCAGGCCAGAAAGAGAGAGTAGCGCGAGCACAGCTAAGGCCACGGAGCGAGACATCTCGGCCCGAATGCTGTCAGCTTCAGGAATGCCCCAG	Seq Percent=151%

TGGTTCACACCCANNNCGAACATGGGGGCATCAGCAGAGGGGGCAGAGATGATGACCCTTTTGGCTCCCCCCTGCAAATGAGCCCCAGCCTTCTCCATGGTGGTGAAGACGCCAGTGGACTCCACGACGTACTCAGCGCCAGCATCGCCC	Seq Percent=150%

TCCATTCTCTGCTGGATGACGTGAGTAAAGCTGAATGGTGGGAGTAAGAGGGATAGCCTCCAGGGCAGAAA	Seq Percent=71%

GCGCGTGATTAGATCGGAAGAGCGTCGTGGATTTCCCTCTTGTACATCGGTGTATCTCTCGGTGGTCGCCGTATCCTTCAAAACCCAAAAAAGAAAAAGAGTAGGTAAACCTCGCAAAACGGGCCTTCCAGCAAAACGTAGCTCAGGGGGA	Seq Percent=151%

TCCATTCTCTGCTGGATGACGTGAGTAAACCTGAATCTTTGGAGTACGCTGGATAGCCTCCAGGCCAGAAA	Seq Percent=71%

CGGGCTGTGTTCACCAGGAAGGCCCCTTGTCTNATCTGCTTGACGGTGAAGTCGCTGATGAGGTGGTGGTTGTGCTCGTTGAGGCCGCAGTGCAGGGTCACGCAGTCGCTGTGGAAGAGCAGGTCCTGCAGGNTGCTGACACGCTGCAGCN	Seq Percent=151%

TCCATTAAAAGCTGGNTGACGAGAGTAAACCTGAATCTTTGGAGTACGCTGGATAGCCTCCAGGAAAGAAAGAGAGAGTAGCGCGAGCACAGCTAAGGCCACGGAGCGAGACATCTCGGCCCGAATGCTGTCAGCTTCAGGAATGCCCCAA	Seq Percent=151%

TCCATTCTCTGNNGGNNNNNNTGAGTAAACCTGAATATTTGGAGTACGCTGGATAGCCTCCAGGCNAGAAANNGAGAGTAGCGCGAGCACAGCTAAGGCCACGGAGCGGGAAAAATCGTCGCGAAAGAGAAGACATGAACGAAGCT	Seq Percent=146%

TCCATTCTCTGNNNGNNNNNNTGAGTAAACCTGAATCTTTGGAGTACGCTGGATAGCCTCCAGGCNAGAAANNGAGAGTAGCGCGAGCACAGCTAAGGCCACGGAGCGAGACATCTCGGCCCGAATGCTGTCAGCTTCAGGTATGCCCCAA	Seq Percent=151%

TCCATTCTCTGCTGGNNGANNTGAGTAAACCTGAATCTTTGGAGTACGCTGGATAGCCTCCAGGCCAGAAAGAGAGAGTAGTGCGAGCACAGCTAAGGCCACGGAGCGAGACATCTCGGCCCGAATGCTGTCAGCTTCAGGAAC	Seq Percent=144%

TCCATTCTCTGCTGGATGACNTGAGTAAACCTGAATCTTTGGAGTACGCTGG	Seq Percent=52%

CGGGATGTGATCACANGGAAGGCACCTTGTCTCATCTGCATG	Seq Percent=42%

TGGTTCACACCCATGNCGAACATGGGGGCATCAGCAGAGGGGGCAGAGATGATGACCCTTTTGGCTCCCCCCTGCAAATGAGCCCCAGCTTTCTCCATGGTGGTGAAGACGCAAGTGGACTCCACGACGTACTCAGCGCCAGCATCGCCC	Seq Percent=150%

TCCATTCTCTGCTTTATGACTTGAGTAAACCTGAATCTTTGTATTACGCTTTATAGCCTCCAGTCCATAAATAGAGAGTAGCGCGAGCACAGCTAAGGCCC	Seq Percent=101%

AAATTGCAGATCGGAGAACGACGGATAGGGAAAGAGTGTACATCGGTGTAGATCTAGGAGGTCACCGTATCATTAAAAAAAAAAAAAATAGAATAGACAAGAAAAAGAAGAAAGAAAAAAAAAAAGAAAAAAAAAGAAAAAGAAAAAAAAA	Seq Percent=151%

TCCATTCTATGNNNNNNTACGTTAGTAAACCTGAATCTTTGGATTACGCTGGAAAGACTCCATGCCAGAA	Seq Percent=70%

TCCATTCTATGCTGGATTACGTTAGTAAACCTGAATCTTTGGATTACGCGGAAAAGCCTCCGGGCCAGAAAGATAGAGTAGCGAGAGCACAGCTAAGGCCAAGGAGCGAGACATCTCGGCCCGAATGCTATCAGCTTAAGGAATTCCCCAG	Seq Percent=151%

TGGTTCACACCCATGACTANNATGGGGGCATCAGCAGAGGGGGCAGAGATGATGACCCTTTTGGCTCCCCCCTTCAAATGAGCCCCAGCCTTCTCCATGGTGGTGAAGACGCCAGTGGACTCCACGACGTACTCAGCGCCAGCATCGCCC	Seq Percent=150%

TCCATTCTCTGCTGGATGACGTGAGTAAACCTGAATCTTTGGAGTACGCTGGATAGCCTCCAGGCCAGA	Seq Percent=69%

TCCAGTCTCNTNNNNNNNNCGTTATTAAACCTGAATCTTTGGAGTACTCTTTATAGAATCAAGNNCANAANNATAGAGTAGAGAGAGCACAGCTAAGGCCACGGAGCGAGACATCGAGGACCTAATGCTGTCATCTGCAGGCCACATAT	Seq Percent=149%

TCCATTCTCTGATGAATGACGTGAGTAAACCTGAATCTTTGGAGTACGCTGGATAGCCTCCAGGCCAGA	Seq Percent=69%

TCCATTCTCTGNNGGNNNNCTTGAGTAAACCTGAATCTTTGGAGTACGCTGGATAGCCTCCAGGCNACAATG	Seq Percent=72%

TCCATTCTCTTCTGNATGACGTTATTAAACC	Seq Percent=31%

TCCATTCTCTGCTGGATGACTTGAGTAAACCTGAATCTTTGGAGTACGCTGGATAGCCTCCAGGCCAGAAAGAGAGAGTAGCGCGAGCACAGCTAAGGT	Seq Percent=99%

TCCATTCTCTGAGGGNNGNNNNGAGTAAACCTGAATCTTTGGAGTACGCTGGATAGCCTCCAGGNNAGAAAGNGAGAGTAGCGCGAGCACAGCTAAGGCCACGGAGCGAGACATCTCGGCGCGAATGCTGTCAGCTTCAGGAAT	Seq Percent=144%

TCCNTTNNNTGNNNNNNNNNNNGAGTAAACCTGAATCTTTGGAGTACGCTGGATAGCCTCCAGNNNNNNNNNNGAGAGTAGCGCGAGCACAGCTAAGGCCACGGAGCGAGACATCTCGGCGCGAATGCTGTCAGCTTCAGGAATGCCC	Seq Percent=148%

GTAAGAGGAAGAGCGGAAGAGATAAGTGTAGGGAAAGAGTGTAAATATGAGAAGATCTCGGAGGGGGAAGAAACATTAAAAAAAAAAAAAAAGGATATGAGAAGCAAATAGGATATAAATAAAGAAGGAAAGAAAAGGAAACAATAAAAAA	Seq Percent=151%

CGGGCTGTGTTNNCCNNNNNNGCCCCTTGTCTCATCTGCTTGACGGTGAAGTCGTTGATGGGGTNNTGA	Seq Percent=69%

GNAAAACAAACAAAAGCAAAATATCCTCCGCCTCCTTCGGCCCAACGCACCCGCCACCTCCTCTAACACGCAACGCTCCCCCCCCACCCCGCGGCTGTTTGCCCGCTCGTTGCTCCCCTGGCGGAGGCGTCGTGGTGGTGGCTGTTCTTTT	Seq Percent=151%

CGGGAAGTGNTNNNNNNNNNNNAAAATTGTATAATCTGCTAGACGGTTAAGTCGTTGATGAGGGNNTNGANNNTCTCGTGGAGGCCGCAGTGCAGGGTCACGCAGTCGCTGTGGAAGAGCAGGTCCTGCAGGGAGATGAGACGCTGAAGCA	Seq Percent=151%

TTAGATGGGAANNGCNNNNNNTAGGGAAAGAGTGTACATCGGTGTAGATCTCGGTGGTCGCCGTANAATTANNAAAAAAAAAAAAAAAAATAAAAAGAAATAGAAAAAGTAAACAAAAAAAAAAAAATAAACAAAAAAAAAGCAAAATTAA	Seq Percent=151%

TCCATTCTCTGNNNGNNNNNNTGAGTAAACCTGAATCTTTGGAGTACGCTGGATAGCCTCCAGGNNAGGTG	Seq Percent=71%

CGGGATGTGTTNNNANNNNNNGCCCAATGTCTAATCTGCTTGACGGTGAAGACGTTGATGAGGTNNTGGATNNGCTCGTGGAGGCCGCAGTGCAGGGTCACGCAGTCGCTGTGGAAGAGCAGGTCCTGCAGGGTGCTGACACGCTGCAGGA	Seq Percent=151%

TGGTTCACACCCATGACGAACATGGGGGCATCAGCAGAGGGGGCAGAGATGATGACCCTTTTAGCTCCCCCCTGCAAATGAGCCCCAGCCTTCTCCATGGTGGTGAAGACGCCTGTGGACTC	Seq Percent=122%

TCCATTCTCTGCTGGNNGNCGTGAGTAAACCTGAATCTTTGGAGTACGCTGGATAGCCTCCAGGCCAGAAG	Seq Percent=71%

TCAATTCTCTGCTGGATGACGTGAGTAAACCTGAATCTTTGGAGTACGCTGGATAGCCTCCAGGCCAGAAAGAGAGAGTAGCGCGAGCACAGCTGAGGCCAC	Seq Percent=102%

TCCATTCTCNGNNNNNNNNNNNGAGTAAACCTGAATCTTTGGAGTACGCTGGATAGAATAAAGNNNNNAANNNAAATAATAAGAGAGTAGTGAAGGGAAAGAGTGTACAACGGTTAAGAACTCGGTGGTCGCCGTCACATACCACAAAAAA	Seq Percent=151%

TCCATTCTCTGCTGNNNGACGTGAGTAAACCTGAATCTTTGGAGTACGCTGGATAGAATCAAGGCCAGAAAGAGATATTCAAAATAACACAGCTAAGGCCACGGAGCGAACCACCGAAAGTAAGAGCGTCGTGTATAGAAAGAATGTACAT	Seq Percent=151%

CATGTTCAAAGNNNGNNNNNNCGTCGTGTAGGGAAAGAGTGTACATCGGTGTAGATAAAGGTGGTNGCCGTNNCAAAAAAAAAAAAAAAAAAAAAAAACACAAACAAAAAAAAAAAAAAATCAAAAAAAAAAACGTATAAAAAACAAGTG	Seq Percent=150%

TCNATTCTCNGNNNNNNNNNNNGAGTAAACCAGATCGGAAGNNNGTCGTGTAGGGAAAGAGTGNNNANNNNNNTAGATCTCGGTGGTCGCCGTATCATTAAAAAAAAAAAAAGAAAAAAAAAAAAAAGAAAAGATAAAAAAAAAAANNANA	Seq Percent=151%

TCCATTCTCTGCTGGNNGNNNTGAGTAAACCTGAATATTTGGAGTCCGCTGGAT	Seq Percent=54%

TGGTTCACACCCATGNCNNNNATGGGGGCGTAAGCAGAGAGGGCAGAGAGATAGGAAGAGAGTCNNGTAGGNNAAGAGTGAACATAGGAGTAGAGAAAGGTGGTCGACGAAAAAAGAAAACCAAAAAAAAAAACACACACAAAACACAGAA	Seq Percent=151%

TCCNTTNNNTGNNNNNNNNNNNGAGTAAACCTGAATCTTTGGAGTACGCTGGATAGAATAAAGNNNNNNNNNNCAAAAGAGAGAAGAGAAGGGAAAGAGAGAACATAGGAGTAGAAAAAGTTGGTCGCCGTATCATACAAACCACAAAACA	Seq Percent=151%

TCCATTCTCTGCTGGATGACGTGAGTAAACCAGAAAATTTGGAGTACGCTGGATAGAATCAAGCCCAGAGAAGAAAGGAAGAGAGAAGAGTAGGGAAAGAGTGTACACAGTAATAGAAAACGAAAAAAAAAAACTCATTAAAAACAAAAAA	Seq Percent=151%

TCCGTTCTGNGNNNNNNNNNNNGAGTAAAACTGAATCTTTGGAGTACGCTAGATAAACTCCAGGNNANAANNNTAGGAAGAGCGTCGTGTCGGGAAAGAGTGTCCATCGGGGTAGAGCTAGGAGGGAGACGAAAAATAAAAAAAAAAG	Seq Percent=148%

TCCATTCTCTGCTGGATGACGTGAGTAAACCTGAATCTTTGGAGTACGCTGGATATCCTCCAGGCCAGGTGAGATCTTAATATCTTCGTGTAGGGAAAGAGTGTACATCTGTGTAGCTCTCGGTGGTCGCCGTATCCTTAAAAAAAAAAAA	Seq Percent=151%

TGGTTCACAACCANNNCGAACATGGGGGCATCAGCAGAGGGGGCAGAGATGATGACCCTTTTGNATCCNCCATGCAAATGAGCCCCAGTCTTCTCCATGGTGGTGAAGACGCAAGTGGAATCCACGCTGTACTC	Seq Percent=134%

TCCATTCAATGNNGTNNNNNNGGAGTAAACCTGAATCTTTGGCGTACGCTGGATAGCCTCCAGGCNATCCCNNG	Seq Percent=74%

TCCATTCTCNGNNNNNNNNNNNGAGTAAACCTGAATCTTTGGAGTACGCTGGATATCCTCCAGNNNNNAANNNGCTATTCTCTCTATCACAGCTAATGCCACGGAGCGATACATCTCTTCCCGAATGCTGTCAGCTTCAGGAATGA	Seq Percent=146%

TTGTTCACACCNATGNNNNNNATTTGGGCATCAGCAGAGGTGGCAG	Seq Percent=46%

TCCATTCTCTTCTGGATGACGTTATTAAACCTGAATCTTTTGAGTACCTGAGGAATATCGGGAAAANACACATTAATATTGCCAGGGTATTTCACTTGGGGCTAACTTGGTGTCAAGCTATATCAATCACCAAGTTTTTACATTTTGTCAT	Seq Percent=151%

TCCATTCTCTGNNNNNNNNNNNGAGTAAACCTGAATCTTTGGAGTACGCTGGAGAGAGTACAGGNNAGAAANNTCGGAAGAGAGGAGAGTAGGGAAAGAGAGTACAGAGTTGTAGAAAAAGGTGGTCGCCGTATCATTAAAAAGAAAAGAA	Seq Percent=151%

TGGTTCACACCNNNNNNNNNNNTGGGGGCATCAGCAGAGGGGGCAGAGATGATGACCCTTTTGGNNCCCCNNNGCAAATGAGCCCCAGCCTTCTCCATTTTGTTTAAGACGCCAGTGGACTCTACGACGTACTCAGCGCCAGCATCGCCC	Seq Percent=150%

TGGTGCTGGGANAGCNNNNNNAGAAGTTCCTGGTGATCCCTTTGCCATCTCCTTGCCTCCACTCACACCTGCCTGTTGGGGAGCCCAGTCCGCCACACTCCTCACACTCCAGCCGTCTCTTGCTGACTGCACAGGTC	Seq Percent=137%

CNGTCTGTGTTNNNNNNNNNNNCCCCTTGTCTCATCTTCTTGACGGTTACGTCTTTTCTTCGGTNNTNGTNNNTCTCTTTTAGTCCTCAGTGCAGGGTCACTCAGTCGCTTTGGAAGCTCAGGTCCTTCATTGTGCTTACACGCTGCATC	Seq Percent=150%

TCAATTCTCTGNNNNNNNNNNTGAGTAAACCTGAATCTTTGGAGTACGCTGGATAGCCTCCAGGNNAGAAANNTCGGAAGAGCGTCGTTTAGGGAAAGATTGTACATCGGTGTAGATCTCGGGGGTCGCCGTATCATTAAAAAAAAAAAAA	Seq Percent=151%

AGGTTCACACCCATGACGANNATGGGGGCGTCAGCAGAGGGGGCAGAGATGATTACCACAGATCGGAAGAGCGTCGTGTAGGTAAATAGAGGAGATCGGAGAAGAGCTCTGTGGTCGCCTTATCATTAAAAAAAAAAAAATAATAGAA	Seq Percent=148%

TCCATTCTCTGCTGGATGACGTGAGTAAACCCGAATCTTTGGAGTACGCTGGATAGCCTCCATGCCAGAAAGATAGGGTAGCGCGATCACAGCTAAGTCCACGGAGCTAGACATCTCGGCCCGAATGCTGTCAGCTTCAGTAATGCCCCAG	Seq Percent=151%

CGACGCTCACCCTTCCTCACACTCCAGCCGTCTCCCGTGGTCACCATTGTATGCACGGCGACTACCATCGTAACCAGATCGGAATATCGAGGTGTAGTGACAAAGAGTACATCGGTGTAGATCTCGGTGGTCGCCTTATCATTAAAAAAAA	Seq Percent=151%

TNCATTCTCTGCTGGATGACGTGAGTAAACCTGAATCTTTGGAGTACGCTGGATAGCCTACAGGCCAGAAAGAGAGAGTAGCGCGAGCACCGCAAATGT	Seq Percent=99%

TGGTTCACACCCATGACGAACATGGGGGCGTCAGCAGAGGGGGCAG	Seq Percent=46%

TCCATTCTCTGNNGGNNNNNNTGAGTAAACCTGAATATTTGGAGTACGCTGGATAGCCTAAAGGCNAGAAAGAGAGAGTAGACACAGCACAGCTAAGGACCCGGAGAGAGAAACATAGGCACGAAGGATGTAACATTCAAGAAAGCCCCAG	Seq Percent=151%

TCCATTCTCTGCTGGATGACGTGAGTAAACCTGAATCTTTGGAGTACGCTGGATAGCCTCCAGGCCAGGAAAGATCGGAAGAGCGTCTTTTATTTAAATATTTTACATCGGTGTAGATCTCGGTGGTCGCCGTATCATTAAAAAAAAAAAA	Seq Percent=151%

TCCATTCTCTGNNGGNNNNNNTGAGTAAACCTGAATCTTTGGAGTACGCTGGATAGCCTCCAGGCCAGAAAGAGAGAGTAGCGCGAGCACATCTAATTCCACTTATCGAGACATCTCGGCCCGAATGCTGTCAGCTTCAGGAAGGCCC	Seq Percent=148%

CGGGCTGTGTTCACNAGGAAGGCCCCTTGTCTCATCTGCTTGACGGTGAAGTCGTTGATGAGGTGGTGNNTGTGCTCGTTGAGGCCGCATTTCATTTTCACGCATTCGCTGTGGAAGAGCAGGTCCTGCAGGGTGCTGACACGCTGCAGN	Seq Percent=150%

CGGGCGGTGTTNACCNNANNNGCCCATTGTCTCATCAGCTTGACGGTGAAGTCGTTGATGAGGTTATGGTTGTGCTCGTTGAAGCCGCAGTGCAGGGTCACGC	Seq Percent=103%

TGGTTCACACCCATGACGAACATGGGGGCATCAGCAGAGGGGGCAGG	Seq Percent=47%

CGGGCTGTGTTCACCAGGAAGGCCCCTTGTCTCATCTGCTTGACGGTGAAGTCGTTGATGAGGTGGTGGTTGTGCTCGTTGAGGCCGCAGTGCAGGGTCACGCAGTCGCTGTGGAAGAGCAGGTCCTGCAGGGTGCTGACACGCTGCAGC	Seq Percent=150%

TGGTTCACACCCATGACGAACATGGGGGCGTCAGCAGAGGGGGCAGAGATGATGACCCTTTTGGCTCCCCCCTGCAAATGAGCCCCAGCCTTCTCCATGGTGGTGAAGACGCCAGTGGACTCCACGACGTACTCAGCGCCAGCATCGCCC	Seq Percent=150%

TCAATTCTCTGATGGAAGAAGTGAGTAAACCTGAATCTTTGGAGAACGCGGGATAGCCTCCAGGAAATGAA	Seq Percent=71%

TGGTAAACACCNNNGNNNNNNAAGGGGGAGTGAGAAGAAGGGCAGAGATAGGAAGAGCGTCGGGTNGGGAANTGGAGAAAATAGGTGTATCTCTCGGTGGTCGCCGTATTAAGAAAAAAAAAAAAAAAAAAAAAGAAAAGAGAAGACCACA	Seq Percent=151%

TCCATTCTCTGCTGGATTACTTGAGTAAACCTGAATCTTTGGAGTACGCTGGATAGCCTCCAGGCAGA	Seq Percent=68%

GCACTGATTAGAAAGGAAGAGCGGAGTGTAGGGAAAGAGTGAAAAACGGAGTAGATCTCGGTGGTGGCAGTAACATTAAAAAAAAAAAAAAAAAAAACCAATAAAAAAATACGAATAAATAAAAAAAAGAAGAAAAAAGAAAAAAAAA	Seq Percent=148%

CGGGCTGTGTTCACCAGGAAGGCCCCTTGTCTCATCTGCTCGACGGTGAAGTCGTTGATGAGGTGGTGGTTGTGCTCGTTGAGGCCGCAGTGCATGG	Seq Percent=97%

TGGTTCACACCCATGNCGAACATGGGGGCGTCAGCAGAGGGGGCAGAGATGATGACCCTTTTGGCTCCCCCCTGCAAATGAGCCCCAGCCTTCTCCATGGTGGGGAAGACGCCAGTGGACTCCACGACGTACTCAGCGCCAGCATCGCCC	Seq Percent=150%

TCCATTCTCTGCTGGATGACGTGAGTAAACCTGAATCTTTGGAGTACAC	Seq Percent=49%

TCCATTCTCTGNNNNNNNNNNTGAGTAAACCTGAATCTTTGGAGTACGCTGGATAGCATCCAGGNN	Seq Percent=66%

TCCATTCTCNGNNNNNNNNNNNGAGTAAACCTGAATCTTTGGAGTACGCTGGATAGCCTCCAGGNNAGAANNNGAGAGTAGCGCGAGCACAGCTAAGGCCACGGAGCGAGACATCTCGGCCCGAATGCTGTCAGCTTCTGGAATGC	Seq Percent=146%

TCCATTCTCTGCTGGATTACTTGAGTAAACCTGAATCTTTGGAGTACGC	Seq Percent=49%

TGGTCCACACCCATGACTAACCTGGGGGCGTCAGCAGAGGGGGCAGAGATGATGACCCTTTTGGCTCCCCCCTGCAAATGAGCCCCAGCCTTCTCCATGGTGGTGAAGACGCCAGTGGACTCNACGACGTACNCAGCGCCAGCATCGCCC	Seq Percent=150%

TCCATTCTCTGCTGGATGACGTGAGTAAACCTTAATCTTTGGAGTACGCTGGATAGCCTCCGGGCCAGTAAGATCTTAATATCGTCTTGTAGGGAAAGATTGTACATCTTTTTATATCTCGGTTTTCTCCTTTTCCTTCTAATAAAAAAAA	Seq Percent=151%

CGGGCTGTGTTCACCNNGANNGCCCCTTGTCTCATCTGCTTGACGGTGAAGTCGTTGATGAGGTGGTGGTTGTGCTCGTTGAGGCCGCAGTGCAGGGTCACGCAGTCGCTGTGGAAGAGCAGGTCCTGCAGGGTGCTGACACGCTGCAGC	Seq Percent=150%

TGGTTCACACCCATGACGAACATGGGGGCGTCAGCAGAGGGGGCAGAGATGATGACCCTTTTGGCTCCCCCCTGCAAATGAGCCCCAGCCTTCTCCATGGTGGTGAAGACGCCAGTGGAC	Seq Percent=120%

CCGTCAGACCGGAAGAGCGTCGTGTAGGGAAATATTTTACATCGGTGTAGATCTCGGTTGTCGCCGTATCATTAATAAAATACAATTAAAAGAGAGAAATGGGGGGGATTTTCTTTTTAAGATTCCATCTCTTTTCTTCTACTAATAAATA	Seq Percent=151%

TCCATTCTCTGCNNNNNGACGTGAGTAAACCTTCATCTTTGGAGTACGCTGGATAGCCTCCAGCCAANAAGATCGGACTCTCTGCGTTTTTGACCTCTTTCCCCCTTTTGAGAACTTGGTGGTTGCCGTCACTATAAAACCCAAAACCAA	Seq Percent=150%

TCCATTCTCTGCTNNNTGACGTGAGTAAACCGGAATCTTTGGAGTACGCCAGAGAGGACGAGCGTCGTNNAGGGAAAGAGGGGAGAGCGTTGGAGATCTCGGTTTTCGGCGGGTCAGGAACAAAAAAAAGGTGTGTAGGGAGGATGGGGTA	Seq Percent=151%

TCCATTCTCTGCTGGATGACGTGAGTAAACCTGAATCTTTGGAGTACGCTGGATAGCCTCCAGGCCAGAAAGAGAGAGTAGCGCGAGCACAGCTAAGACCACGGAGCGAGACATCTCGGCCCGAATGCTGTCAGCTTCAGGAATGG	Seq Percent=146%

TCCANTCTCTGCTGGATGACGTGAGNAAACCTNNATCTTTGGAGTACGCTGGATAGCCTCCAGGCATCN	Seq Percent=69%

TCCATTCTCTGNTGGNNNNNNTGAGTAAACCTGAATCTTTGGAGTACGCTGGATAGCCTCCAGGCCAGAAAGACAG	Seq Percent=76%

TCCATTCTCTGNNNNNNNNNNNGAGTAAACCTTAATCTTTGGAGTACGCTGGATAGCCTCCAGGNNAGCAANNATCTTAATATCGTCGTGTAGGGAAAGAGTGTACATCTTTTTATATCTCGTTTTTCTCCTTATCATTCACTAAAAAAAA	Seq Percent=151%

TCNATTCTCTGNNNNNNGACGTGNGACCCAGATCTTAATAGNNNCGTGTAGGTAAAGATTTTANATCNNNNTAGATCTCTTTTGTCTCCGGATGATTAAAAAAAAAAATATCTATACAAATATACTAACCCTCATTATCTTCTATCNNAAT	Seq Percent=151%

TCCATTCTCTGCTGGATGACGTGAGTAAACCTGAATCTTTGGAGTACGCTGGATAGCCTCCAGGCCAGAAAGAGAGAGTAGCGCGAGCACAGCTAAGGCCACGGAGCGAGACATCTCGGCCCGATTGCTGTC	Seq Percent=132%

TCCATTCTCTGCTGGATGACGTGAGTAAACCTGAATCTTTGGAGTACGCTGGATAGCCACCAGGCAC	Seq Percent=67%

TCCATTCTCTGNNNGNNNNNNNGAGTAAACCTGAATCTTTGGAGTACGCTGGATAGCCTCCAGGNNAAAT	Seq Percent=70%

TCCATTCTCTGNNGGNNNNNNTGAGTAAACCTTAATATTTGGAGTACGCTGGATAGCCTCCAAGCCAGAAAGAGAGATTATCTCGATCACAGCCAAGTCCAGATCGGACGAGCGTCTTGTAGTTAAAGAGATTACATAGTTTAAGATCT	Seq Percent=149%

TCCATTCTCNGNNNNNNNNNNNGAGTAAACCTTAATATTTGGAGTACGCTGGATAGCCTCCAAGNNAGAANNNGAGATCTTAAAGCTTCGTGTAGGGAAAGAGTGTACCAAGGATTAGATCTCTGAGGTAGCCGTATAATTCAACACAAAA	Seq Percent=151%

CGGGNTGTGTTNNCCNNNNNNGCCCCTTGTCTCATATGATTGACGGTGAAGTAGATGATGAGGTGNTGGNTGTGATAGTTGAGGAGGCAGTGCATGGACACGGCTGGGCTGTGTAAGAGAAGNACATGCAGGNTGCGGAANAGATTCAGCN	Seq Percent=151%

TGGTNCCCCCCCATGACGAACCTGGGGGCCTCCGCAGCGGGGGCCG	Seq Percent=46%

TCCATTCTCTGNNNNNNNNNNTGAGTAAACCTGAATCTTTGGAGTACGCTGGATAGCCTCCAGGNNAGTGA	Seq Percent=71%

TCCATTCTCTGCTGGATGACGTGAGTAAACCTGAATCTTTGGAGTACGCTGGATAGCCTCCAGGCCAGAAAGAGAGAGTAGCGCGAGCACAGCTAAGGCCACGGAGCGAGACATCTCGGCCCGAATGCTGTCAGCTTCAGAAATGCCC	Seq Percent=148%

TGGTTCACACCCATGACGAACATGGGGGCATAAGAAGAGGTGGCAGAGATGAGGACCCAGAAGGCTCCCCCCTGAAAAAGAGAGAAAGAAGTCCAAAGGGTGGTGAAGAGGAAAGAGGAATCAAAGAGGTAGTAAGAGAAAGAATAGCCC	Seq Percent=150%

TCCATTCTCTGNNGGNNNNNNTGAGTAAACCTGAATCTTTGGAGTACGCTGGATAGCCTCCAGGCNAGAAAGAGAGAGTAGCGCGATCACAGCTAAGGCCACGGAGCTAGACATCTCGTCCCTAATGCTGTCAGCTTCATTAATGCCCCGA	Seq Percent=151%

TCCANTCTCTGCTGGATGACGTGAGNAAACCTNNATCTTA	Seq Percent=40%

TCCANTCTCTGCTGNCTGACGTGAGNNAAGATNNAAGAGCGTNNNGTAGGNNAAGAGTGTACATCGGTNNAGATCTCGGNGNTGGCCGTATCATTAAAAAAAAAAAAAAAAAAANAAATAGNNAAAAAAAAANAACACAGNACAAAAAANN	Seq Percent=151%

TGGTTCACACCNNTGNNNNNNATGGGGGCATCAGCAGAGGGGGC	Seq Percent=44%

TCCATTCTCTGNTGGNNNNNNTGAGTAAACCTGAATCTTTGGAGTACGCTGGATAGCCGCCAGGCNCAG	Seq Percent=69%

TCCATTCTCTGCTGGATGANNTGAGTCAACCTGACTCATAGGCTCACGCTGGATAGCCTCCATGCCAGAAAGAGAGAGTAGCGCGAGCACAGAGATCGGAAGAGCGTCGGGTAGTGAAAGTGTGAAGATGGGTTTAGGGCTCGGTGGTCT	Seq Percent=150%

TCCATTCTCTGCTGGATGACGTGAGTCAACCTGACGCTTTGGCTCACGCTGGATAGCCTCAATGGCC	Seq Percent=67%

TCCATTCTCTGCTGGATGANNTGAGTAAACCTGAATCTTTGGAATAC	Seq Percent=47%

TCCATTCTCTGCTGGATGACGTGAGTAAACCTGAATCTTTGGAGTACGCTGGATAGCCTCCAGGCCAGAAAGAGAGAGTAGCGCGAGCACAGCTAAGGCCACGGAGCGAGACATCTCGGCCCGAATGCTGTCAGCTTCAGGAATCTC	Seq Percent=147%

TCCATTCTCNGNNNNNNNNNNNGAGTCAACCTGACGCTGGGGCTCACGCTGGATAGCCTCCGTNNNNNGCNNNTAGGAAGAGCGACGTGTAGTGAAAGAGTGTACATCGGTAAGTATCGGGGTGAGGGCGGTCTCATGGCAAAACANAATA	Seq Percent=151%

TCCATTCTCTGCTGGATGACGTGAGTAAACCTGAATCTTTGGAGTACGCTGGATGTCCTCCAGGCCAGA	Seq Percent=69%

TCCATTCTCTGCTGGATGACGTGAGTAAACCTGCATCTTTGGAGTACGCTGGAGAGAATCCAGGCCAGAAAGAGAGATTAGAGAGAGCACAAATAGGGCCCGGGAGGGAGACATCTGGGACCGAATGCTGTCAGCTTCAGGACACGATCGG	Seq Percent=151%

TCCANTCTCTGCTNNATGACGTGAGGAAACCTGAATATTTGGNNNACGCTGGATAGCCGAAANGCCAGNNAGAGAGAGTAGAGAGAGAACAGCTAAGGAAAAGGAGAGAGAAACATAGGACNGAATGAAGTGANCTGGGCAAAGCCCCANN	Seq Percent=151%

TGGTTCACACCNNTGNNNNNNATGGGGGCATCAGCAGAGGGGGCAGAGATGATGACCCTTTTGGNNCCCCCNNGCAAATGAGCCCCAGCCTTCTCCATGGTGGTGAAGACGCCAGTGTACTCCACGACGTACTCAGCGCCAGCATCGCCC	Seq Percent=150%

TCCATTCTCTGCTGGATGACGTGAGTAAACCTGCATCTTTGGAGTACGCTGGAGAGAATCCAGGCCAGAAAGAGAGATTAGAGAGAGCACAGATAAGGCCACGGAGCGAGACATCTCGGACCGAATGCTGTCAGCTTCAGGAAAC	Seq Percent=145%

GGGAAAGAGTGTTGATTAAGAGATAGGAAAGAGTAGTGTAGGGAAAGAGTGAAGATCGGTGAAGATCTCGGTGGGGGGGGAATAAATAAAAAAAAAAAGGGTCAAAGAGAGGGAGAGAAAAAAAGAAAAAAAACGCAAAGGAACTAGTAAA	Seq Percent=151%

TCCATTCTCTGNNGGNNNNNNTGAGTAAACCTGAATCTTTGGAGTACGCTGGATATCCTCCAGGNNAGAA	Seq Percent=70%

GCTTTATTAGATCNNNGAGCGTAGTGTAGGAGAAAAGAGAACATCGGTGTAGAAATGGGAGGGCGCCGGATTATAAAAAAAAAAAAATAAATTAAAAAATAGAGAGCAAGTAAACAAAAACAAAAAAACTATTGATATGGAGCACGAAACA	Seq Percent=151%

ACCATTCTCTGCTGGATGACGTGAGTAAACCTGAATCTTTGGAGTACGCTGGATAGCCTCCAGGCCAGAAAGAGAGAGTAGCGCGAGCAGATCTAATTCCACTGCGCGAGACATCTCGGCCCGAATGCTGTCAGCTTCAGGAATGC	Seq Percent=146%

CGGGCTGTGTTNNCCNNNNNNGCCCCTTGTCTCATCTGCTTGACGGTGAAGTCGTTTATGAGGTGNTGGTTGTGCTCGTTGAGGCCGCAGTGCATTTTGAGGCAGTCGCTGTGGAAGAGCAGGTCCTGCAGGGTGCTGACACGCTGCATC	Seq Percent=150%

TCCATTCTCTGCTGGATGANNTGAGTAAACCTGAATCTTTGGAGTACGCTGGATAGCCTCCAGGCCTGAAA	Seq Percent=71%

TCCATTCTCTGCTGGATGACGTGAGTAAACCTGAATCTTTGGAGTACGCTGGATAGCCTCCAGGCCAGAATG	Seq Percent=72%

TCCCTTCTCTGCTGGATGACGTTAGTAACCCTGAATCTTCTGAGTACTCTGGATAGCCTCCAGGCCAG	Seq Percent=68%

CGGGCTGTGTTCACCNGGAAGGCCCCTTGTCTCATCTGCTTGACGGTGAAGTCGTTGATGAGGTGGTGGTTGTGCTCGTTGAGGCCGCAGTGCAGGGTTAGGC	Seq Percent=103%

TCCATTCTCNGNNNNNNNNNNNGAGTAAACCTGAATCTTTGGAGTACGCTGGATAGCCTCCAGNNNNNAAN	Seq Percent=71%

TCCATTCTCTGCTGGATGACGTGAGTAAACCTGAATCTTTGGAGTACGCTGGATAGAATCAAGGCCAGAAAGAGAGAGTAACGAGAGGACAGCTAAGGCCACGGAGCGAGACATCTAGGACCNAATGCTGTCAGCTTCAGNACAGCCC	Seq Percent=148%

TGGTTCACACCCATGACGAACATGGGGGCATCAGCAGAGGGGGCAGAGATGATGACCCTTTTGGCTCCCCCCTGCAAATGAGCCCCAGCCTTCTCCATGGTGGTGAAGACGCCAGTGGACTCCACGACGTACTCAGCGCCAGCATCGCCC	Seq Percent=150%

TCCATTCTCNGNNNNNNNNNNNGAGTAAACCTGAATCTTTGGAGTACGCTGGATAGCCTCCAGNNNNNA	Seq Percent=69%

GGCTGCATTAGNNCGNNNNNNCTTCTTGTAGTTAAATATTTTACATCTTTGTAGATCTCTTTTGTCGCCGTATCATTAAAAAAAAAATCAAAAAAATCTTTCAATTTAATTATAAAGATAAATCAATAAAAAATAACGAATAAATCGA	Seq Percent=148%

TGGTTCACACCCATGACGAACATGGGGGCGTCAGCAGAGGGGGCAGAGATGATGACCCTTTTGGCTCCCCCCTGCAAATGAGCCCCAGCCTTCTCCATGGTGGTGAAGACGCCAGTGGACTCCACGACGTACTCAGCGCCAGCATCGCCC	Seq Percent=150%

TCCATTCTCTGNNNNNNNNNNNGAGTAAACCTTAATCTTTGGAGTACGCTGGATAGCCTCCAGGNNAAACANNTCTAAATAGCGTCGTGTAGGGAAAGAGTGTACATCGTTTTATATCTCGGTTTTCTCCGTCTCATTACTCAAAAAAAAA	Seq Percent=151%

TCCATTCTCTGNNGGNNNNNNTGAGTAAACCTGAATCTTTGGAGTACGCTGGATAGCCTCCAGGNNAGAAANNGAGAGTAGCGCGAGCACAGCTAAGGCCACGGATCGAGACATCTCGTCCCGAATGCTTC	Seq Percent=131%

TCCANTCTCTGCTGGATGACGTGAGNAAACCANAATATTTGGAGTACGCTNNATAGCCAACAGGCCAGNNAGATAGGAAGAGCGAAGAGTAGGGAAAGAGAGTACATAGGAGAANATCTAGNGGGAAGAGTANTACATAAAAAACAAAANN	Seq Percent=151%

TCCANTCTCTGCTGGATGACGTGAGTAAACCTAAATATTTGGAGTAGATCGGAAGAGCGAAGTGTAGGGAAAGAAAAAAAAGAGGGGGATATATAGGGGGGGGCCGGAGAAAAAAAAAAACAAAAAAAAACAACACACGCAAAACATAANN	Seq Percent=151%

TCCATTCTCTGNNNGNNNNNNTGAGTAAACCTTAATATTTGGAGTACGCTGGATAGCCTACAGGNNAGAAANNGAGATTAGTGCGAGAC	Seq Percent=89%

ATGCGTGAGATCAGAAGAGCGTCGAGGAGGGAAAGAGAGAACATCGGGGGAGATCTCGGTGGGCGCCGTATCAATAAAAAAAAAACCAAAAAAATATATAAATAAAGAAGAAAAAAAAAATAAAAAAAAAAAAAGAAAAAAAACTACAAAA	Seq Percent=151%

TCCATTCTCTGCTGGNNGACGTGAGTAAACCTGAATCTTTGGAGTACGCTGGATAGCCTCCAGGCCAT	Seq Percent=68%

TCCATTCTCTGCTGGATGACGTGAGTAAACCTGAATCTTTGGAGTACGCTGGATAGCCTCCAGACCAGAACG	Seq Percent=72%

TCCATTCTCTGNTGGNNNNNNTGAGTAAACCTGAATCTTTGGAGTACGCTGGATAGCCTCCGGGCCAAAA	Seq Percent=70%

TCCATTCTCTGCTGGNNGANNTGAGTAAACCTGAATCTTTGGAGTACGCTGGATAGCCTCCAGCCCAGAAAG	Seq Percent=72%

TCCATTCTCTGNNGGNNNNNNTGAGTAAACCTGAATCTTTGGAGTACGCTGGATAGCCTCCAGGNNAGAGAN	Seq Percent=72%

AAAATTTTTGTTTTGGGGGGAGGGGGGGGGGGGGGGAAGGGGGAGTGGGGGGGGGGGTTTTGGGGGGGGGGGGTTTTTTAAAAAAAAAAAAAAAAAAAGAGATTAAAAAGAATCAAAACAAAAAGAGAAAATAAAATAAAATAAGTAAGAA	Seq Percent=151%

TCCNTTNNNTGNNNNNNNNNNNGAGTAAACCTGAATCTTTGGAGTACGCTGTATAGCCTCCAGGNNNGAAANNGATAGTAGCTCGAGCACAGCTAAGGCCACGGAGCGATACATCTCGGCCCTAATGCTGTCAGCTCCATGAATCACATCG	Seq Percent=151%

CGGGCTGTGTTCACCAGGAAGGCCCCTTGTCTCATCTGCTTGACGGTGAAGTCGTTGATGAGGTGGTGGTTGTGCTCGTTGAGGCCGCAGTGCAGGGTCACGCAGTCGCTGTGGAAGAGCAGGTCCTGCAGGGTGCTGACACGCTGCAGC	Seq Percent=150%

TCCATTCTCTGNNGGNNNNNNTGAGTAAACCTGAATCTTTGGAGTACGCTGGATAGCCTCCAGGCNAGAAANNGAGAGTAGCGCGAGCACAGCTAAGGCCACGGAGCGAGACATCTCGGCCCGAATGCTGTCAGCTTCAGGAATGCCCCAG	Seq Percent=151%

TACGTGGATNTNNNNNNNNNNNCTCAGCGCCTTCTCATCCACCAAAAGTGGCCCACTAGGCACNNNNNTTNNNCGCCCGGCTCCACGCCAGCGAGCCGGGCTTCTTACCCATTTAAAGTTTGAGAATAGGTTGAGATCGTTTCGGCCCCAA	Seq Percent=151%

TCCATTNNNTGNNNNNNNNNNNGAGTAAACCTGAATCTTTGGAGTACGCTGGATAGCCTCCAGNNNNNNNNNNGAGAGTAGCGCGAGCACAGCTAAGGCCACGGAGCGAGACATCTCGGCCCGAATGCTGTCAGCTTCAGGAATGCCTCAG	Seq Percent=151%

CAGGAATTCAANNTTNNNNNNGTCTGTGGAACCCTTCTTCAAAGTCTTCACTGCTACTTTGATTTCTCCACTTCCAACTCCTAAGATGTCCACTGCTGTTCCTTCATACACTTCTCCACAGGCTCCACTTCCCAGCGAG	Seq Percent=139%

CGGGCTGTGTTCACCAGGAAGGCCCCTTGTCTCATCTGCTTGACGGTGAAGTCGTTGATGAGGTGGTGGTTGTGCTCGTTGAGGCCGCAGTGCAGGGTCACGCAGTCGCTGTGGAAGAGCAGGTCCTGCAGGGTGCTGACACGCTGCAGC	Seq Percent=150%

TGGTTCACACCCATGACGAACATGGGGGCGTCAGCAGAGGGGGCAGAGATGATGACCCTTTTGGCTCCCCCCTGCAAATGAGCCCCAGCCTTCTCCCTGTTTTTTCAGACGCCAGTGGACTCCACGACGTACTCAGCGCCAGCATCGCCC	Seq Percent=150%

TCCANTCTCTGCTGGATGACGTGAGNNAACCTNAATCTTTGGAGTACGCTNGATAGCCTCCAGGCCAGNNAGAGAGAGTAGCGCGAGCACAGCTAAGGCCACGGAGCGAGACATNTCGGCCNGAATGCTGTCNGCTTCAGGAATGCCCCNN	Seq Percent=151%

TCCATTCTCTGCTGGATGACGTGAGTAAACCTGAATCTTTGGAGTACGCTGGATAGCCTCCAGGCCGTAAAG	Seq Percent=72%

TCCATTCTCNGNNNNNNNNNNNGAGTAAACATTAATCTTTGGCTTAAGCCGGATATCCTCCAGGNNANCANNN	Seq Percent=73%

TTGTTCACANCNNNNNNNNNNNTGGGGGCATCAGCAGAGGTGGCGGATATGATGACCCTTTTGGNNTNCCNNNTCAAATGAGCCCCAGCCTTCTCCATGGTGGTGAAGACGCCAGTGGACTCCACGACGTACTCAGCTCCAGCATTGCCC	Seq Percent=150%

TCCCTTCTCTGCTGGATGACGTTAGTAAACCTTAATCTTTTGGGTACGCTGGATATCCTCCGGGCAAGAA	Seq Percent=70%

TCCATTCTCNGNNNNNNNNNNNGAGTAAACCTGAATCTTTGGAGTACGCTGGATAGCCTCCAGNNNNNAGN	Seq Percent=71%

TCCATTCTCNGNNNNNNNNNNNGAGTAAACCTTAATCTTTGGAGTACGCTGGATAGCCTTCAGNNNNNATNNNAATATCGTCTTGTAGGGCAAGATTTTACATATGTGTAGATCTCTTTTGTCTCCGTATCATTAAAAAAAAAAAAAAAAA	Seq Percent=151%

TCCATTCTCTGCTGGNTGACGTGAGTAAACCTGAATCTTTGGAGTACGCTGGATAGCCTCCAGGCCAGAAAGAGAGAGTAGCGCGAGCACAGCTAAGGCCACGGAGCGAGACATCTCGGCCCGAATGCTGTCAGCTTTAGGAATC	Seq Percent=145%

TCCATTCTCTGNNNGNNNNNNTGAGTAAACCTGAATCTTTGGAGTACGCTGGATAGCCTCCAGGNNAGAAANNGAGAGTAGCGCGAGCACAGCTAAGGCCACGGAGCGAGACATCTCGGCCCGAATGCTGTCAGCTTCAGGAATGCCCCAT	Seq Percent=151%

TCCATTCTCTGNNGGNNNNNNTGAGTAAACCTGAAA	Seq Percent=36%

AGGTCTGTGTTCACCAGGAAGGCCCCGTGTCTCATCTGCTTGACGGTGAAGTGGGTGATGAGGTGGTGNNTGAGCTCGTTGAGGCGGCAGTGCAGGGTCACTAGT	Seq Percent=105%

TCCATTCTCGGAGGGAAGACGTGAGTAAACCTGAATCTTTGGAGTACGCGGGATAGCCTCCAGGCCAGAAAGATAGAGTAGAGCGAGCACAACTAAAGCCAAGGAGCGAGACAACTCGGCCCGAAAGCTGTCAGCTTCAGGAAGCCAGATA	Seq Percent=151%

CACTAGCGTAGNNTANNNNNNGAGTGTACATAAAAGAAAATCAGGGTGGACGACAGATCAAAAAANAAAAAAACAAGGAAAACAAAAAAACAAAAACAACAAAAAAAAATAGAAAGAAAAAAAAAACAAAAGGAACAAACAAAATAAAATA	Seq Percent=151%

TGGTTCACACCCATGNNGAANATGGGGGCATCAGCAGAGGGGGCAG	Seq Percent=46%

TCCATTCTCTGCTGGATGACGTGAGTAAACCTGAATCTTTGGAGT	Seq Percent=45%

TCCATTCTCTGNNNGNNNNNNTGAGTAAACCTGAATCTTTGGAGTACGCTGGATAGAATAAAGGNNAGCAAN	Seq Percent=72%

TCCATTCTCNGNNNNNNNNNNNGAGTAAACCTGAATCTTTGGAGTACGCTGGATAGAATAAAGNNNNNNNNNNGAGAGTAGCGCGATAACAGCTAAGGAAAAGGAGAGAGACATCTCTGCCCGAATGCTGTCAGCTTCAGGAATGCNN	Seq Percent=148%

TGGTTCACACCNNNGNNNNNNNTGGGGGCATCAGCAGAGGGGGCAGAGATGACGACCCTTTTGGNNCNCCNNNGCAAATGAGCCCCAGCCTTCTCCATGGTGGTGAAGACGCCAGTGGACTCCACGACGTACTCAGCGCCAGCATCGCCC	Seq Percent=150%

CCATTCTCTGCTGGANGNNNNGAGTAAACCTGAATCTTTGGAGTACGCTGGATAGCCTCCAGGCNNA	Seq Percent=67%

TAAAAAATATAAACNGGAAAGTTTAAGTGTGGTGTAGGGGTTNTTAGTTGTTGGGGAGGAGGGCGGTGNNTATGGGGGGTGAGAGAGTGGTGATGGAGGAGGAAGAGGAGGAAATAAAAGAAAAAAGAGTGGTAAGGATAGTAGAGCTGNT	Seq Percent=151%

TCCANTCTCTGCTNNATGACGTGAGNNAACCNNNATCTTTGGNNNACGCTNNAGAGAAACCGNGCCAGNNAGAGAGCGNNAGAGAGACGTGTAGGGAAAGAGTGTACAAGGGTGNAGAGATNNGTGGTCGCCNNATGATNCACACAAAANN	Seq Percent=151%

TCCATTCTCTGNNNGNNNNNNTGAGTAAACCTGAATCTTTGGAGTACGCTGGATAGCCTCCAGGNNAGAANNNGAGAGTAGCGCGAGCACCGCTCCTTCCACTGCTCGAGACATCTCGGCCCGAATGCTGTCAGCTTCAGGCATGCCCCAG	Seq Percent=151%

TCCATTAAATGATTGATGAAGAGAGTAAAACTGAATATTTGGAGTACGATGGATAGCCACCAATCAATATCACAAGAGCGTCGTGAAGGGAAAGAGTGTACATCGGTGTAGATGTCGGGGGTCGCCGAAGCAAGAAAAAAAAAAAAACAAA	Seq Percent=151%

TCCATTCTCTGCTTGNNGACNTTAGTAAACCTTAATCTTTTGAGTACTCTGGAAAAAATACAGGCCATAAAGAGAGAGTAGCGCTAGAACCAAGAAGGAAAAGGAGAACTACATCTCGGCCGGAATGCTGTCAGCTTCAGGAATGCCC	Seq Percent=148%

CGGGCTGTGTTNNCCNNNNNNGCCCCCTGTCTCATCTGCTTGACGGTGAAGTCGTTGATTAGGTNNTGGTTNNG	Seq Percent=74%

CAGGAATTCNANNNNNNNNNNNTCTGTGGAACCCTTCTTCACTTCGGCCTTCAAAGTTCTCGTNNNANTANNNGCTACTACCACCAAGATCTGCCCCTGCGGCGTCTCCACCCGGGCCCGCGCCCTAGGCTTCAAGGCC	Seq Percent=139%

TCCATTCTCTGNNGGNNNNNNTGAGTAAACCTGAATCTTTGGAGTACGCTGGATAGCCTCCAGGNNAGAAANNGATCGGAAGAGCGTCGTTTATTTCCAGAGTGTCAATCGGTGTAGATCTCGGTGGTCGCCGTATCATTAAAAAAAAAAA	Seq Percent=151%

TCCATTCTCTGNNNNNNNNNNTTAGTAAACCTTAATCTTTTGAGTACTCTGGAAAAAATACAGTNNANAANNNGAGAGTAGCGCTAGAACCAAGAAGGAAAAGGAGAACTACATCTCGGCCGGAATGCTGTCAGCTTCAGGAATGCCCCA	Seq Percent=150%

CAGGAATTCAATCTTCNCCNNGTCTGTGGAACCCTTCTTCAAAGTCTTCACTGCTACTTTGATTTCTCCACTTCCAACTCCTAAGATGCCCACTGCTGTTCCTTCATACACTTCTCCAAAGGCTCCACCTCCCAGCA	Seq Percent=137%

TCCATTCTCTGCTGGNTGACGTGAGTAAACCTGAATCTTTGGAGTACGCTGGATAGCCTCCAGGCCAGAA	Seq Percent=70%

TGCAGAGGTTATGAGATCGGAAGGGCGAAGAGTAGGGAAAGAGTGTAGAGCGGTGTAGATCGCGGTAGTCGCCGTATCATTAAAAAAAAAAAAGAAGGAAAAGAGGAGAAACAAGAAGAAAAAAAAAAAAAAGATACAAAACAACACAGCA	Seq Percent=151%

CAGGAATTCNANNNNNNNNNNNTCTGTGGAACCCTTCTTCAAAGTCTTCACTGCTACTTTGATNNNNNCANNNCCAACTCCTAAGATGTCCACTGCTGTTCCTTCATACACTTCTCCAAAGGCTCCACTTCCCAGCAAGAGACGCANNGT	Seq Percent=150%

TCCATTCTCTGNNGGNNNNNNTGAGTAAACCTGAATCTTTGGAGTACGCTGGATAGCCTCCAGGNNACAA	Seq Percent=70%

TACATTCTCTGNNNNNNNNNNNGAGTAAACCTGAATCTTTGGAGTACTCTGGATAGCCTCCAGNNNANGGN	Seq Percent=71%

CCCATTCTCTGCTGGATGACGTGAGTAAACCTGAATCTTTGTATTACGCTGGATAGCCTCCAGGCCCGTAT	Seq Percent=71%

TGGTTCACACCNNNGNNNNNNATGGGGGCATCAGCAGAGGGGGCAGATATGATGACCCTTTTGGNNCCCCNNNGCAAATGAGCCCCAGCCTTCTCCATGGTGGTGAAGACGCCAGAGGACTCCACGACGTACTCAGCTCCAGCATCGCCG	Seq Percent=150%

CGGNCTGTGNTNNNNNNNNAGGCCCCTTGTCTCATCTGCTTNACGGTGAAGTCGTTGATGAGGNNGTNNNNNNGCTCGTTGAGGCCGCAGTGCAGGGTCACGCAGTCGCTGTGGAAGAGCAGGTCCTGCAGGGTGCTGACACGCNGNNGN	Seq Percent=150%

TCCATTCTCNGNNNNNNNNNNNGAGTAAACCTGAATCTTTGGAGTACGCTGGATAGCCTCCAGGNNANAA	Seq Percent=70%

TGGTTCACACCNATGNNGNNNATGGGGGCGTCAGCAGAGGGGGCAGAGATAATGACCCTTTTGGCTCCCCCCTGCAAATGAGCCCCAGCCTTCTCCATGGTGGTGAAGACGCCAGTGGACTCCACGACGTACTCAGCGCCAGCATCGCCC	Seq Percent=150%

GGGANCGCGTCGTNNAGGGAAAGAGTGTACATCGGTGTAGATNNNGGTGGTCGCCTTATCATTAAAAANNAAAAAAAACAAAAAAACACGTCAAACTACTAAAGAAAACAAAAAATAGGAAAAAATACGAAACACGACAATGAAAAGTANA	Seq Percent=151%

TCCANTCTCTGCTNNATGACGTGAGNNAACCNNNATCTTTGGNGNACGCTNNATAGCCTCCAGGCCAGNNAGAGAGAGNNGCGCGAGCACATCTCAGGCCCCGTACCGAGACATNTCGGCCNGAATGCTGTCNNCTTCANGAATGCCCCNN	Seq Percent=151%

TCCATTCTCTGCTGGATGACGTGAGTAAACCTGAATCTTTGGAGTACGCTGGATATCCTCCAGGCCAGAAAGAGATAGTAGCGCTAGCACAGCTAATTCCACGGAGCGAGACATCTCGGCCCGAATGCTGTCAGCTTCAGTAATGCCCCAG	Seq Percent=151%

TCCATTCTCTGNNNNNNNNNNNGGGTAAACCTGAATCTTTGGAGTACGCTGGATAGCCTCCAGANNAGATNNNAAGAGCGTCGTGTAGGGAAGGAGTGTACATCGGTGTAGATCTCGGTGGTCGCCGTATCATTAAAAAAAAAAAAAAAAA	Seq Percent=151%

TCCATTCTCTGCTGGATGACGTGAGTAAACCTGAATCTTTGGAGTACGCTGGATAGCCTCCGGCCAAA	Seq Percent=68%

GCACGGGAAACCTCACCCGGCCCGGACACGGACAGGATTGACAGATTGATAGCTCTTTCTCGATTCCGTGGGTGGTGGTGCATGGCCGTTCTTAGTTGGTGGAGCGATTTGTCTGGTTAATTCCGATAACGAACGAGACTCTGGCATGCTA	Seq Percent=151%

TGGTNCACACCCANNNCGAACATGNNNGCATNNNCAGAGGGGNNNGAGATNNTGACCCTTTNNGCTCCNNCCTGCAAATGAGCCCCAGCCTTCTCCATGGTGGTGAAGACGCCNGTGGACTNCNCGACGTACTNNGCGCNAGCATCGCCNN	Seq Percent=151%

TCCATTCTCTGCTGGATGACGTGAGTAAACCTGAATCTTTGGGGTACGCTGGATAGCCTCCAGGCCAGAAAGAGAGAGTAGCGCGAGCACCTCCAAGGCCA	Seq Percent=101%

TCCATTCTCTGNNNNNNNNNNNGAGTAAACCTGAATCTTTGGAGTACGCTGGATAGCCTCCAGGNNCAGANN	Seq Percent=72%

CGGGNTGTGTTCANNAGGAAGGCCCNNTGTCTNNTCTGCTTGNCNGTGAANNCGTTGATGAGGTGGTGNNTGTGCTCGNTGAGGCCGCAGTGCAGGGTCACGCAGTCGCTGTGGAAGAGCANGTCCTGCAGGNNGCTGANACGCTGCAGNN	Seq Percent=151%

TCCATTCTCTGCTGGANGANNTGATTCAACCTTCATCTTTGTATTACTCTCTAAAGAGTCCCTTCCATAACGAGAGATTCTCGAAAGCACAGATAAGGCCAAGGAGCGACACATCTCAGACTTCATTCTGTACTCTTCATTACATCTCCAT	Seq Percent=151%

TGGTTCACACCNNNNNNGAACATGGGGGCATCAGCAGAGGGGGCAGAGATGATGACCCTTTTGGCTCCCCNNTGCAAATGAGCCCCAGCCTTCTCCATGGTGGTGAAGACGCCAGTGGACTCCACGACGTACTTAGCGCCAG	Seq Percent=142%

CTGTGTAGTCAAGNNNGGAAGACGTCGTGTAGGGAAAGAGTGTACATCGGTGTAGATCTCGGTGGTCGCCGTATCATTAAAAAAAAAAATCAAAAAAAAACATGAAAAAGAAAAAAAGAATAAAACAAAGAAGGAAAGAAGAAAGAAAGAG	Seq Percent=151%

CGGGCTGTGTTCACCAGGAAGGCCCCTTGTCTCATCTGCTTGACGGTGAAGTCGTTGATGAGGTGGTGGTTGTGCTCGTTGAGGCCGCATTGCAGGGTCACGCAGTCGCTGTGGAAGAGCAGGTCCTGCAGGGTGCTGACACGCTGCAGC	Seq Percent=150%

TCCANTCTCTGCTNNATGACGTGANNNAACCNNNATCTTTGGNNNACGCTNNATAGCCTCCANGCCAGNNAGATCGGANNNNCGTCGTGTAGGGAAAGAGTGTACATCGGTGTANATCTCGNNGGTCGCCGTNNCATTANNAAAAAAAANN	Seq Percent=151%

CGGGCTGTGTTNNCCANNNNNGCCCCTTGTCTCATCTGCTTGACGGCGAAGTCGTTGATGAGGTGNTGGTTNTGCTCGTTGAGGCCGCAGTGCAGGGTCACGCATTCGCTT	Seq Percent=111%

TCCATTCTCTGNNGGNNNNNNTGAGTAAACCTGAATCTTTGGAGTACGCTGGATAGCCTCCGGGNNAGAA	Seq Percent=70%

TCCATTCTCTGCTGGATGACGTGAGTAAACCTGAATCTTTGGAGTACGCTGGATAGCCTCCAGGCATGATC	Seq Percent=71%

TCCATTCTCTGCTGGATGACGTGAGTAAACCTGAATCTTTGGAGTACGCTGGATAGCCTCCTGGCCAGAA	Seq Percent=70%

TCCATTCTCNGNNNNNNGACGTGAGTAAACCTGAATCTTTGGAGTACGCTGGATAGCCTCCAGNCCANAANNAGAGAGTAGCGCGAGCACAGCTAAGGCCACGGAGCGAGACATCTCGGCCCGAATGCTGTCAGCTTCAGGAATGCCC	Seq Percent=148%

TCCATTCTCTGCTGGATGACGTGAGTAAACCTGAATCTTTGGAGTACGCTGGATAGCCTCCAGGCCAGAAAGAGAGAGTAGCGCGAGCACAGTA	Seq Percent=94%

TCCATTCTCTGCTGGATGACGTGAGTAAACCTGAATCTTTGGAGTACGCTGGATAGCCTCCATGGGAA	Seq Percent=68%

ACCATTCTCTGNNNNNNNNNNNGAGTAAACCTGAATCTTTGGAGTACGCTGGATATCCTCCAGGNNANAANNNGAGAGTATCTCTCGCCGAGATAAGTCTCCGGAGCTCTACATCTCCGCCCGAATGCTGTCAGCTTCAGTAATGCC	Seq Percent=147%

TCCATTCTCTGNNGGNNNNNNNGAGTAACCCTGAATCTTTGGAGTACGCTGGGTAGAATCAAGGNNAGAGNNNAGCGGAAGAGAGTAGATTATTTAAAGAGGTACCAAAGTTGTTGATAACGGTGGTCGCCGTATCACTCACCACAAAAAA	Seq Percent=151%

TCCATTATAAGNNTTNNGACGTGAGTAAACCTGAATCTTTGGAGTACGCTGGATAGCCTCCAGGAAAGAAAGAGAGAGTAGCGCGAGCACAGCTAAGGCCACGGAGCGAGACATCTCGGCCCGATTGCTGTCAGCTTCAGGAATGCCC	Seq Percent=148%

CGGGCTGTGTTCACCAGGAAGGCCCCTTGTCTCATCTGCTTGACGGTGAAGTCGTTGATGAGGTGGTGGTTGTGCTCATTGAGGCCGCAGTGCAGGGTCACGCAGTCGCTGTGGAAGAGCAGGTCCTGCAGGGTGCTGACACGCTGCAGC	Seq Percent=150%

CGGGCTGTGTTNNCCNNNNNNGCCCCTTGTCTCATCTGCTTGACGGTGAAGTCGATGATGAGGTGNTGGTTGNGCGCGTTGAGGAAGAATTTCATGGCAACGCATAAGATGTGGCAGATAAGGTCCTGCAGGGTGCTTACACGATGCAGC	Seq Percent=150%

TCCATTATAAGNNTTNNNNNNTGAGTAAACCTGAATCTTTGGAGTACGCTGGATAGCCTCCAGGNNAGAAG	Seq Percent=71%

TCCATTCTCTGNNNNNNNNNNNGAGTAAACCTGAATCTTTGGAGTACGCTGGATAGCCTCCAGTNNAGAANNNGAGAGTAGCGCGAGCATCTCTCAGGCCCCTTCGCGAGACATCTCGGCCCGAATGCTGTCAGCTTCAGGAATGCCCCAG	Seq Percent=151%

TCCATTCTCTGNNGGNNNNNNTGAGTAAACCTGAATCTTTGGAGTACGCTGGATAGCCTCCAGGNNAGAAANN	Seq Percent=73%

TGGCTCACACCNNNNNNNNNNNTGGGGTCTTCAGCAGATTGGGCAGATATGATGACCCTATTGGNNCNCGNNNTCAAATGAGGCCCAGGCTAAGACAGGGGGGGGGAGACGCCAGTGGAGTCCACGACGTACTCAGCGCCAGCATGGCCA	Seq Percent=150%

TCCATTCTCTGCTGGATGACGTGAGTAAACCTGAATCTTTGGAGTACGCTGGATAGCCTCCAGGCCAGAAAA	Seq Percent=72%

CGGGCTGTGNTNNNNNNNNNNNCCCCTTGTCTCATCTGCTTGACGGTGAAGTCGTTGATGAGGNNNTNGTNNNGCTCGTTGAGGCCGCAGTGCAGGGTCACGCAGTCGCTGTGGAAGAGCAGGTCCTGCAGGGTGCTGACACGCTGCGGC	Seq Percent=150%

TCCATTNNNNGNNNNNNNNNNNGAGTAAACCTGAATCTTTGGAGTACGCTGGATAGCCTCCAGNNNNNAANNNG	Seq Percent=74%

TCCANTCTCTGCTNNCTGAAGTGANNNAACCNNNATCTTTGGNNNACGCTNNATAGCCTCNANGCCAGNNAGAGAGAGNNNNGCGAGCACAGCTTGAGATCGGAAGNGCGTCGNNTAGGGANNGAGTGTACANNNGTGTNNATCTCGGTNN	Seq Percent=151%

TCCATTATATGCTTTANGANNGGAGTAAAACTGAATCTTTGTCTTACGTTGGATAGCCTCCAGTCCACCCCGAGAGAGTAGCGCGAGCACAGCTAAGGCCACGGAGCGAGACATCTCGGCCCGAATGCTGTCAGCTGCAGGAAGGGCCAC	Seq Percent=150%

TCCATTCTCNGNNNNNNNNNGTGAGTAAAAATGAATATTTGGAGTACGCTGGATAGAATCCAGNNCANATNNNAACGGAGAGAGACGTGTAGGGAAAGAGTGTACATCGGATACAATCTCGGACAAATCGGACTCATCATAAAACAAAAAA	Seq Percent=151%

TCCATTCTCTGNNGGNNNNNNNGAGTAAACCTGAATCTTTGGAGTACGCTGGATAGCCTCCAGTNNAGCGCNN	Seq Percent=73%

TCCATTNNNNGNNNNNNNNNNNGAGTAAACCTGAATCTTTGGAGTACGCTGGATAGCCTCCAGNNNNNNNNNNAGGAAGAGCGTCGTGTAGGGAAAGAGTGTACATCGGTGTAGATCTCGGTGGTCGCCGTATCATTGAAAAAAAAAAAAA	Seq Percent=151%

TCCANTCTCTGCTNNATGACGTGAGNNAAAANNNATATTAGGNNNACGCTNNATAGAATCCAGGCCAGNNAGAGAGAGNNNNGCGAGAACAGCTAAGGCCACGGAGNGAGACATNTCGGCCNNAATACTGTANNCGTCANNAATCCAGANN	Seq Percent=151%

TGGTTCACACCCATGNNGNNNATGGGGGCGTCAGCAGAGGGGGCAGAGATGATGACCCTTTTGGCTCCCCCCTGCAAATGAGCCCCAGCCTTCTCCATGGTGGTGAAGACGCCAGTGGACTCCACGACGTACTCAGCGCCAGCATCGCCC	Seq Percent=150%

TCCATTCTCTGCTGGATGACGTGAGTAAACCTGAATCTTTGGAGTACGCTGGATAGCCTCCAGGCCAGAG	Seq Percent=70%

CTAGTAATTTGNNAANNNNNNGTTTATTTGGGAATCC	Seq Percent=37%

TCCATTNNNNGNNNNNNNNNNNGAGTAAACCTGAATCTTTGGAGTACGCTGGATAGCCTCCAGNNNNNNNNNNGAGAGTAGCGCGAGCACAGCTAAGGCCACGGAGCGAGACATCTCGGCCCGAATGCTGTCAGCTTCAGGAAAGCNGAT	Seq Percent=150%

TCCATTCTCTGCTNNATGACGTGAGNAAACCTNAATCTTTGGNGTACGCTGGATAGCCTCCAGGCCAGNNAT	Seq Percent=72%

TCCANTCTCTGCTNNATGACGTGAGNNAACCTNNATCTTTGGNGTACGCTNNATAGCCTCCAGGCCAGNNAGAGAGAGTNGCGCGAGCACAGCTAAGGCGAGATCGGAAGAGCGNCGTGTANNGAAAGAGTGNNCATCGNTGTAGATCTNN	Seq Percent=151%

CGGGCTGTGTTNNCCNNNNNNNCCCCTTGTCTCATCTGCTTGACGGTGGAGTCGTTGATGAGGTNNTGGTTNNGCTCGTTGAGGCCGCAGTGCAGGGTGACGCAGTGGCTGTGGAAGAGCAGGTCCTGCAGGGTGCGGACAGGCTGCAGC	Seq Percent=150%

TGGTTCACACCNNTGNNNNNNATGGGGGCATCAGCAGAGGGGGCAGAGATGATGACCCTTTTGGCNCCCCCNNGCAAATGAGCCCCAGACTTCTCCATGGTGGTGAAGACGCCAGTGGACTCCACGACGTACTCAGCGCCAGCATCGCCC	Seq Percent=150%

TCCANTCTCTGCTNNATGACGTGAGNNAACCTNNATCTTTGGNGNACGCTNNATAGCCACCAGTCC	Seq Percent=66%

CAGGAATTCAANCTTNNCNNNGTCTGTGGAACCCTTCTTCAAAGTCTTCACTGCTACTTTGATTTCTCCACTTCCAACTCCTAAGATGTCCACTGCTGTTCCTTCATACACTTCTCCAAAGGCTCCACTTCCCAGCAAGAGACGCAGAGT	Seq Percent=150%

TCCATTCTCTGNNGGNNNNNNTGAGTAAACCTGAATCTTTGGAGTACGCTGGATAGCCTCCAGGCNAGAATNN	Seq Percent=73%

TCCATTCTCTGNTGGNNGNNNTGAGTAAACCCGAATCTTTGGAGTACGCTGGATAGCCTCCAGGCCAGAAAGAGAGAGTAGCGCGAGCACATCTAAGGCCA	Seq Percent=101%

TCCATTCTCTGCTGGATGACGTGAGTAAACCTGAATCTTTGGAGTACGCTGGATAACCTCTAAGCCAGAACAGATCGGAAGAGCGTCGTGTAAGTCCCTAGTAAAACTCGGTGTAGATCTCGGTGGTCGCCGTATCATTAAAAAAAAAAAA	Seq Percent=151%

CACCCCNNNNTNNNNNNNNNNNTGATTCTCTAATCTTCTATGCCAGACAAAGGTCAGTGGGATNNNNNNNNNNAGAAATATTCCAACTATAATAGTAAGTATGAAACTTGTTTCTGGTATCCAA	Seq Percent=124%

TCCATTCTCTGCTGGATGACGTGAGTAAACCTGAATCTTTGGAGTACGCTGGATAGCCTCCAGGCCAGAAGAGATCGGAAGAGCGTCGTGTAGATCCCTAGTGAACCTCGGTGTAGATCTCGGTGGTCGCCGTATCATTAAAAAAAAAAAA	Seq Percent=151%

TCCATTCTCTGNNGGNNNNNNTGAGTAAACCTGAATCTTTGGAGTACGCTGGATAGCCTGCAGGNNAGAAGNNGTCGGAAGCGCGTCGGGTAGGGAAATAGAGTACCACGGTGTAGCTCTCGGTGGTCGCCGTATCATTATAAAAAAAAAA	Seq Percent=151%

TCCATTCTCTGCTGGATGACGTGAGNAAACCTGAATCTTTGGAGTACGCTGGATAGCCTCCAGGCTAAGATCGGAAGAGNGTCGTGTCGGGAAATCGTTTACAACGTTGTAGATNTCGGTGGNCGCCGTATCNTTAAAAANAAAAAAAANA	Seq Percent=151%

TGGTTCACANCNNNNNNNNNNNTGGGGGCATCAGCAGAGGGCAGAGAGATCGGAAGAGCGTCGNNNANGGNNNGAGTGTACATCGGTGTCGATCTCGGTGGTCGCCGTATCATTAAAAAAAAAAAAAAAAAAGAAAGAGAGAGGAAGAGAA	Seq Percent=151%

GGATCTCGACGCTCTCCCTTCCAAATTCGCCTTCTCCTAGAGTTCTCGTTTGAATATTTGCTACTACCACAGAGATCGGAACAGCGTCGGTGGGAGAGTGTGGGGCCCGGTGTAGACCTCGGTGGTCGCCGTATCATTAACAAAAAAAAAA	Seq Percent=151%

TCAGTGTAGGGAAAGAGTGTAGGCCTCTTAGATCGTAAGAGCGTCGTTTATTTAAAGATTGTACATCGGTGTAGATCTCTTTTGTCTCCATATCATTAAAAAAAAAAAATGTAGATAAAACCTATCACCAGACACTAGCTAAAACAAACAA	Seq Percent=151%

AGGGCTGTGTTNACCNNNNNNGCCCCTTGTCTCATCTGCTTGACGGTGAAGTCGTTGATGAGGTGNTGGTTGTGCTCGTTGGGGCCGCAGTGGG	Seq Percent=94%

CATGCGNNNNCNNNNNNNNNNNAGCGTCGTGTAGGGAAAGANTGTACATCGGTGTAGATCTCGNNNNNNNNNNTATCATTAAAAAAAAAAATTCAAAAACAAATAAAAAGACAAGAAATATAAACAAATAAAAAAAAAAAAAAAAANN	Seq Percent=148%

GAATTTTTAGATGGAAGAGCGTCGTGTATTGGAAGAGTGTACATCGGTGTAGGTCTGGGTGGTCGCCGGATCATTAAAAAAAAAAGAAAAAAATAAAAGAAGAAGCAAGGTAGAAGAAGAGAAGTAAGGAAAGAGAGAAATTAGCGACGGA	Seq Percent=151%

TCCATTCTCNGNNNNNNNNCGTGAGTAAACCTGAATCTTTGGAGTACGCTGGATAGCCTCCAGNCCANAANNGATCGGAAGAGCGTCGTGTATGTAAAGATTGTACATCGGTGTAGATCTCGGTGGTCGCCGTATCATTAAAAAAAAAAAA	Seq Percent=151%

AGGTTCACACCCATGACGAACATGGGGGCGTCAGCAGAGGGGGCAGAGATGATGACCCTTTTGGCTCCCCCCTGCAAATGAGCCCCAGCATTATACATTGTGGTGACGACGCCAGTGGACTCCACGACGTACTCAGCGCCAGCATCGCCAA	Seq Percent=151%

CGGGCTGTGTTCANNAGGAAGGCCCCTTGTCTCATCTGCTTGACGGTGAAGTCGTTGATGAGGTGGTGGTTGTGCTCGTTGAGGCCGCATTGCAGGGTCACGCATTCGCTGTGGAAGAGCAGGTCCTGCAGGGTGCTGACACGCTGCAGC	Seq Percent=150%

ACCATTCTCTGCTGGATGACGTGAGTAAACCTGAATCTTTGGAGTACGCTGGATAGCCTACAGGCCAGAA	Seq Percent=70%

TCCATTCTCTGCTGGATGACGTTAGTAAACCTGAATCTTTGGAGTACGCTGGATAGCCTCCAGGCCAA	Seq Percent=68%

TCCCNTCTCTGCTNNATGACGTTANNNAACCNNNATCTTTGGNNNACGCTNNATAGCCTCNNNGCCAGNNAGATAGAGNNNNGCGAGNNCAGCTAAGGNNNCGGAGNNGGACANNTNGGCCNNGATGCTGTNNNNTTCANNAAGCTAGGNN	Seq Percent=151%

TCCATTCTCTGCTGGATGACGTTAGTAAATCTGAATCTTTGGAGTACGCTGGATAGCCTCCAGGCCAGAAAG	Seq Percent=72%

TGGTNCACACCCANNACGAACATGNNNGCGTNNNCAGAGGGGNNNGAGATNATGACCCTTNTNGCTCCNNCCTGCAAANNNNCCCCAGNCTTCTCCATNGTAGTGANGACGCCNNTGGACTNNACGACGTANNNNGCGCNNGCATCGCCNN	Seq Percent=151%

TCCATTCTCNGNNNNNNNNNNNGAGTAAACCTGAATCTTTGGAGTACGCTGGATAGCCTCCAGNNNNNAANNNGAGAGTAGCGCGAGCACATCTAAGGCCACGTATCGAGACATCTCGGCCCGAATACTGTC	Seq Percent=132%

AGGTTCCCCCCCATGACGAACATGGTTTCTTCAGCAGAGGGGGCAGCTATGATGACCCTATTGGCTCCNNCCTGCAAATGAGCCCCAGCCTTAAACATGAAAGAGACGACGCCAGTGGACTCCACGACATCCTCACCTCCACCATCGACN	Seq Percent=150%

TCCATTCTCTGCTGGNNGANNTGAGTAAACCTGAATCTTTGGAGTACGCTGGATAGCCTACAGGCCAGCATAGATCGGAAGAGCGTCGTGTAGAAAAAGAAAGAAAATCGGTGTAGATCTCGGTGGTCGCCGTATCATTAAAAAAAAAAAA	Seq Percent=151%

ACCATTCTCTGCTGAATGACGTGAGTAAACCTGAATCTTTGGAGTACGCTGGATAGCCTACAGGCCAGAAAGAGAGAGTAGCGCGAGCACAGAAACGGCAAAGGAGCGAGACATCTCGGCCCGAATGCTGTCAGCTTCAGGAATGCCCCAG	Seq Percent=151%

CGGGNTGTGTTCANNAGGAAGGCCNNNTGTCNNNTCTGCTTGNNNGTGAANTCATAGATGAGNTGGTGNNTGTGCTCGNTTCGGCCTCAGTGCAGGGTCACGCAGTCGCTGTGGNCTAGCANNTCCTGCAGNNNNCTGANACGCTGCAGNN	Seq Percent=151%

TCCATTCTCTGNNGGNNNNNNTGAGNAAACCAGAAAATATGGAGTACGCTGGAGAGAAACCAGGNNAGAAANNGAGAGANGCGAGAGCACATCTAAGGCCACGTATNGAGTAATNACGGACCNAATGATGTCNGCTGCAGNACACAGATNG	Seq Percent=151%

CANTCTCTAGCCGTCTCTTCACCGTGCCAGAAAAGAGAAACGCTCAACAGGGGATTATATCCCCGCTGATTCCGAAAAGACCGATAACTTGTCTGTGGTTTCGCTTGAAACAAGGAAGGGTCAGTGGAAATCTCGTACATACAATCATGCG	Seq Percent=151%

TCCATTCTCTGNTGGNNNNNNTGAGTAAACCTGAATCTTTGGAGTACGCTGGATAGCCTCCAGGCNAGAAAGAGAG	Seq Percent=76%

TCCATTCTCTGCTNNATGACGTGANNNAACCTGAATCTTTGGNGNACGCTNGATAGCCTCCAGGCCAGNNAGAGAGATTAGCGCGATCACAGCTAAGGCCACGGAGCGAGACATCTCGGCCNGAATGCTGTCANCTTCANGAATTCCCANN	Seq Percent=151%

TCCATTCTCTGCTGGNTGACGTGAGTAAACCTGAATCTTTGGAGTACGCTGGATAGCCTCCAGGCCAGAA	Seq Percent=70%

CGGGNGGTGGTCGNNNGGAAGGCNCCTTGTCTCATCTGCTTNNNNGTGGAGTCGTTGATGAGGTGGGNNNTGTGCTCGTTGAGGCCGCAGTGCGGGGTCACGCAGTCGCTGTGGAAGAGCAGGTCCTGGAGGGGGCTGACACGCGGGAGN	Seq Percent=150%

CGGGCTGGGTTCACCAGGAAGGCCCCTTGTCTCATCTGCTTGACGGTGAAGTCGTTGATGAGGTGGTGGTTGTGCTCGTTGAGGCCGCAGTGCAGGGTCACGCAGTCGCTGTGGAAGAGCAGGTCCTGCAGGGTGCTGACACGCTGCAGC	Seq Percent=150%

AGTTCGAGGTCNNNNNNNNNNNGTGTAGGTAAAGAGTGTACATCGGTGTAGATCTCGGCGGTCGNNGTATNNNTAAAAAAAAAAAATAAAAAAATAAAACGGCGGGATGAGAATTCCGAAAAACGAAAAACAACATCGATAATAATAACAT	Seq Percent=151%

CGNGCTNNNNTNNNNNNNNNNNCCCCTTGTCTCATCTGCTTGACGGTGAAGTCGTTGATGAGGNNNNNGNNNNGCTCGTTGAGGCCGCAGTGCAGGGTCACGCAGTCGCTGTGGAAGAGCAGGTCCTGCAGGGTGCTGACACGCTGNNGC	Seq Percent=150%

TGGTTCACACCCATGACGAACATGGGGGCGTCAGCAGAGGGGGCAG	Seq Percent=46%

TCCATTCTCTGCTNGATGACGTGAGNAAACCNNAATCTTTGGAGTACGCTNGATAGCCTCCAGGCCATNNAAGAGATCGNANGAGCGNCGTGTAGGGANAGAGTGTNCATCGGGNTAGATCNNGGTGGGCGGNGTGTCANNAAAGAGGANN	Seq Percent=151%

TGGTTCACANCNNNNNNNNNNNTGGGGGCATCAGCAGAGGGGGCAGAGATGATGACCCTTTTGNNNGNACNNNGCAAATGAGCCCCAGCCTTCTCCATGGTGGTGAAGACGCCAGTGGACTCCACGACGTAGTCAGCGCCAGCATCGCCC	Seq Percent=150%

TCCATTCTCTGNNGGNNNNNNTGAGTAAACCTGAATCTTTGGAGTACGCTGGATAGCCTCCAGGNNAGAAANNGAGATTAGCGCGATCACAGCTAAGGCCACGGAGCGAGACATCTCGGCCCGAATGCTGTCAGCTTCAGGAATTCC	Seq Percent=147%

TGGTTCNNNNCNNNNNNNNNNNTGGGGGCTTCAGCAGAGGGGGCAGAGATGATGACCCTTTTGNNNNNNNNNNGCAAATTAGCCCCCGCCTTCTCCATGGTGGTGAAGACGCCATTTGACTCCACGACGTACTCAGCGCCAGCATCGNCC	Seq Percent=150%

TCCATTCTCTGCTGGATGACGTGAGTGAACCTGAATCTTTGGAGTACGCTGGATAGCCTCCAGGCCAA	Seq Percent=68%

AGATGAGAAGANNNNNNNNNNNGGAAAGAGTGTACATCGGTGTAGATCTCGGTGGTCGCCGTANNNTTAANNNAAAAAAAACAAAAACAAAAAAAAGATAGAAGAAGGAAAAAAAAAAGAAAAGAAGGAAAGATAAAAAAAAGAAAGAGAG	Seq Percent=151%

TCCATTNNNTGNNNNNNNNNNNGAGTAANNCTGAATCTTTGGAGTACNNTGGATAGCCTCCAANNNNNNNNNNNCGGAAGAGCGTCGTGTAGGGAAAGAGTGTACATCGGTGTAGATCTCGGTGGTCGCCGTATCATTAAAAAAAAAAAAA	Seq Percent=151%

GCCTAGAGTTCNNNNNNGCNNNGTGTAGGGAAAGAGTGTACATCGGTGTAGATCTCGGTGGTCGNNGTATCANTAAAAAAAAAAAAAAAAAAAATAAAAAAGAGAAAAGAAATAATAAAAAAGAAAAAAGAAAAGAGAAAAGAGGAGATAA	Seq Percent=151%

TCCATTCTCTGCTGGATGACGTGAGTAAACCTGAATCAG	Seq Percent=39%

TCCATTCTCTGCTGGATGACGTGAGTAAACCTGAATCTTTGTAGTACGCTGGATAGCCTCCAGGCCAGAAAGAGAGAGTAGCGCGAGCACAGCTAAGGCCACGGAGCGAGACATCTCGGCCCGAATGCTGTCAGCTTCAGGTATGCCC	Seq Percent=148%

TCCATTCTCTGNNNNNNNNNNTGAGTAAACCTGAATCTTTGGAGTACGCTGGATAGCCTCCAGGNNAGAAANNGAGAGTAGCGCGAGCACAGCTAAGGCCACGGAGCGAGACATCTCGGCCCGAATGCTGTCAGCTTCAGGTATGCC	Seq Percent=147%

TCCACTAGAGGNNNNNNNNNNNGAGAAAACCAGAATCTTTGGAGAACGCTGGATAGCCTCCAGNNNAGAANNNGAGAGT	Seq Percent=79%

AAAGCAGGGAGGAAGAGCGTTGAGTAGGGAAAGAGTGTACAAGGGTGTAGATCTCGGGGGTCGCCGGATCATTAAAAAAAAAAAAGAAGAGAAGGGAAGACAAGAAAAGAGGGGGGTAATAAATGAAAGTGGGAAGGAAAGGGTAAAAAAA	Seq Percent=151%

TCCATTCTCTGCTNNNTGACGTGAGTAAACCTGAATCTTTGGANTACGTTGGATAGCCTCCAGGCCAGNNAGAGAGAGTAGCGCGAGCACAGCTAAGGCCACGGAGCGAGACATCTCGGCCCGAATGCTGTCAGCTTCAGGAATGCCCCAA	Seq Percent=151%

TCCATTCTCTGCTGTATGACGTGAGTAAACCTGAATCTTTGGATTACGCTGGATAGCCTCCAGGCCAAAA	Seq Percent=70%

CGGGCTGTGTTCACCATGAAGGCCCNCTGTCTCATCTGCTTGAAGGTGAAGTCTTTTATGAGGTGGTGGGTGAGCTCGTTTATGCCGCAACCCAA	Seq Percent=95%

TCCATTCTCTGNNGGNNNNNNTGAGTAAACCTGAATCTTGGGAGTAGCTAGAAAGGAAGAGCGTNNTGTANNNAAAGAGAGAAAAGAGGTGTAGAGAAAGGTGGTGGAGGTATCCAGAAACAGAAAAGAAAAAAACACACACCACAGA	Seq Percent=148%

TCCATTCTCTGNNGGNNNNNNNGAGTAAACCTGAATCTTTGTAGTACGCTGGATAGCCTCCAGGNNAGAAANNGAGAGTAGCGCGAGCACAGCTAAGGCCACGGAGCGAGACATCTCGGCCCGAATGCTGTCAGCATC	Seq Percent=138%

TCGTGCGCAGANNNNNNNNNNNCGTCGTGTAGGGAAAGAGTGTACATCGTTGTAGATCTCTGANNNCGAANNNTAATTAAAAAAAAAAAAAAGCACAAAAAAAAAAGAGACAAACGAAGCCATAAAGCAAAAAACATTACAAACAAAATGA	Seq Percent=151%

GGCTGCATGAAGTTTNNACNNGGTAAAACTCATTTTATTTCCACTTCTGTATCTCAACCCAAAANNTGATGANGTTAACATTCAATTTAGCCTTCCAATTAAATTGCAAACTAGTTCTCTCTTTAACCAATGAATAATTTTTCTCTGGTGT	Seq Percent=151%

TCCATTCTCTGCNNNNNGACGTGAGTAAACCTGAATCTTTGGAGTACGCTGGATAGCCTCCAGNCCANAAAGGT	Seq Percent=74%

ACCATTCTCTGCTNNATGACGTGAGTAAACCTGAATCTTTGGAGTACGCTTTATAGCCTACAGGCCAGNNAGAGAGATTATCCCGATCATCACTATGTCAAAGGCGCTAGACATCTCTGCCCTAATGCTTTCATCTTCAGGAATTCCCCAT	Seq Percent=151%

TCCATTCNCNGNNNNNNNNNNNTAGTAAACCTTAATCTTTTNNNTACNCTGGATAGCCTCCAGNNNANNNNNNGAGATTAGCGCGAGCACAGCTAAGGCCACGGAGATCGTAATAGCGTCGTTTAGGGAAAGAGTTAACATCGGTGNNANA	Seq Percent=151%

TCCATTCTCTGNTGGANGANNTTAGTAAACCTTAATCTTTTGAGTACTCTGGATACAATCAAGGCCAGAAAGAGAGATTAGCGCGAGCACAGAAAAGGCCACGGAGCGAGCCATCTCGACCCTAACGCTGTCAAT	Seq Percent=135%

TACATTCTCTGNNGNANNNNNAGAGTAAACCTGAATCTTTGGAGTTA	Seq Percent=47%

TGGTGAAAGTAGCAAATATTCAAAAGAGAACTTTGAAGGCCGAAGTGAAGAAGGGTACCATGAGAACAGCAGTTGAACATGGATCAGTCGGTCCTGAGAGATGGGCGAGAGCCGTTCCGAAGGGACGGGCGATGGCCTCCGTTGCCCTCGG	Seq Percent=151%

TCCATTCTCAGATGAATGACGTGANNNAACCNNNATCTTTGNNNNACGCNNGATAGCCTCNANGCAAGNNAAATCGGANNNNCGACNTGTAGGGAAAGANNGTACNNCGGAGTNNATCTCGNNGATCGCAGNNNAATAANNAAAAAAAANN	Seq Percent=151%

TCCATTCTCTGCTGGATGACGTGAGTAAAACTGAATCTTTGGAGTACNCTGGATAGCCTCCAGGCCAGAAAG	Seq Percent=72%

TACATTCTCTGCTNGATGACGTGAANAAACCNNGATCTTTGAGGTACGCANATCGGAAGAGCGTCGTGNAGGGAAAGANNGTACATCGGTGTAGATCTCGGTGATCGCCATAACNTTAAAANNAAAAAAGAANAAAAAAAGAGAAAACGNN	Seq Percent=151%

TCCATTCTCNNNNNNNNNNNNNGAGTAAACATGAATATTTGGAGTACGCTGGATAGCCTCCANNNNANAANNNGAAAGTAGCGCGAGCACAGCTAGGGCCAAC	Seq Percent=103%

TCCATTCTCTGCCNNCTTCCTTGCTTCAACCTTCATCTTTGTCTTACGCTTCATAGCCTCCCTACCACCCGGCGATCCTCCTAGCGTCTAGTAGGGACCTCATGACCCTCGGATTCCATCACTCTGGTCGACTTATCAATCAAAAAAAAC	Seq Percent=150%

TAATTCACACCNNTNANNNNNATGAGGGGGTCAGCAGAAGAGGCAGAGATGATGACCCTTTTGGNTCCCCCCNGCAAATGAGCCCCAGCCTTCTCCATGGTGGTGAAGACGCCAGTGGACACCACGACATACTCAGCGCCAGCATCGCCC	Seq Percent=150%

CGGGCTGTGTTCACCAGGAAGGCCCCTTGTCTCATCGGCTTGACGGTGAAGTCGTTGATGAGGTGGTGGTTGTGCTCGTTGAGGCCGCAGTGCAGGGTCACGCAGTCGCTGTGGAAGAGCAGGTCATGCAGGGAGCTGACACGCTGCAGC	Seq Percent=150%

TCCATTAACTGATGGATGACGTGAGTAAATCGAAAGAGCGTCGTGTAGGGAAAAAGTGAACATCAGTGGAGATCTAGGAGATCGCCATATCATAAAAAAAAAAAAAAAAGAAAAAAAGAAAAAAAAAAAAAAAAAAAAAAATAAAAAAAAA	Seq Percent=151%

CGGGCTGTGTTCNNNNGGAAGGCCCCTTGTCTCATCTGCTTNANGGTGAAGTCGCTGATGAGNTGGTNNNTGTGCTCGTTGAGGCCGCAGTGCAGGGTCACACAGTCGC	Seq Percent=109%

TCCAGTCTATGCTGGANGNNNTGAGTAAACCTGAATCTATGGAGTACGCTGGATAGCCACCAGGCGAAAAAGAGAGAGTAGCGAGAGCACAGCTAAGGACACGGAGCGAGACATCTCGGCCCGAATGCTGTCAGCTTCAGGATTGCCC	Seq Percent=148%

TCCATTCTCTGNAGNANNNCGTGAGTAAACCTGAATCTTTGGAGTACGCTGGATAGCCTCCAGGCCAGAAAGAGAGAGTAGCGCGAGCACAGCTAAGGCAACGGAGCGAGACATCTCGGCCCGAATGCTGTCAGCTTCAGGATTGCCC	Seq Percent=148%

TCCATTCTCNGNNNNNNNNNNNGAGTAAACCTGAATCTTTGGAGTACGCTGGATAGCCTCCAGNNNANAANNNGAGAGTAGCGCGAGCACAGCTAAGGCCACGGAGCGAGACATCTCGGCCCGAATGCTGTCAGCTTCAGGAATC	Seq Percent=145%

CTTGCTGACNNNNNNNNNNNNNGGGNNGCCCNNCTCCTCGNCNACATCTGNAGGTGGCAGACANNNANNNNNNCAGGGNNCNGGCCTNGGCCCAGCGTNNNGCCAGNGCCCAAGNACAGGGNNCAGCACCAGNTGAGCTNNCCACGGATNN	Seq Percent=151%

TCCATTCTCTGNTGNANNNNNTGAGTAAACCTGAATCTTTGGAGTACGCTGGATAGCCTCCAGGNNAGAAG	Seq Percent=71%

TCCATTCTCTGNNNNNNNNNNTGAGTAAACCTGAATCTTTGGAGTACGCTGGATAGCCTCCAGGNNAGAAG	Seq Percent=71%

TGGTTCACACCNATNANNNNNATGGGGGCATCAGCAGAGGGGGCAGAGATGATGACCCTTTTGGNNCCCCCCTGCAAATGAGCCCCAGCCTTCTCCATGGTGGTGAAGACGCCAGTAGACTCCACGACGTACTCAGCGCCAGCATCGCCC	Seq Percent=150%

TGGTTCACACCNNNNNNNNNNATGGGGGCATCAGCAGAGGGGGCAGAGATGATGACCCTTTTGGNNCCCCCCNGCAAATGAGCCCCAGCCTTCTCCATGGTGGTGAAGACGCCAGTAGACTCCACGACGTACTCAGCGCCAGCATCGCCC	Seq Percent=150%

TGGTTCACACCCATGACGAACATGGGGGCGTCAGCAGAGGGGGCAGAGATGATGACCCTTTTGGCTCCCCCCTGCAAATGAGCCCCAGCCTTCTCCATGGTGGTGAAGACGCCAGTGGACTCCACGACGTACTCAGCGCCAGCATCGCCC	Seq Percent=150%

TCCATTCTCTGCTNGATGACGTGANNNAACCNNAATCTTTGGNGNACGCNNGATAGCCTCNANGCCAGNNAGAGAGAGNNNNGCGANGATCGGAAGAGCGTCGTGNAGGGAAANNGTGTACNNCGGTGTAGNNNTCGGTNNTCGCCGTANN	Seq Percent=151%

TCCATTCTCTGCTNGATGACGTGAGNAAACCNNAATCTTTGGAGTACGCTNGATAGCCTCCAGGCCAGNAAGAGAGAGNNGNGCGA	Seq Percent=86%

TCCATTCTCTGCTGGATGACGTGAGTAAACCTGAATCTTTGGAGTACGCTGGATAGCCTCCAGGCTAAAAG	Seq Percent=71%

TATAATTCTTTNNNNNNNNNNTGGATTATATTTTTTTTTTTGTAATTTTTGGATAAGATAAAGGNNAGGANNNGAGGGATGTGAGAGAGAAGAGAGTGTAGGGGGGTGTGTGATCACAAAAAAAAAAAAAAAAAAAAAAAAAAAAAAAAAA	Seq Percent=151%

AAAAAAAAAAAAAAAGAAAAAAAAAAAAAAATAAAAAAGGAAGGAAAGAAAGAATAGGGAGAATGTTGGATGTGGGGGTGAAGAGAGGAAAGAAAAAGAGAGAAGAAAACAAAAAAAAAAAAAAAAATAAAAAGAATAAAAAAAAAAGATT	Seq Percent=151%

TCCATTCTCTGNTGNANNNNNTGAGTAAACCTGAATATTCGGAGTACGCTGGATAGCCTCCAGGCNAAAAG	Seq Percent=71%

TGGTTCACACCCATGACGAACATGGGGGCGTCAGCAGAGGGGGCAG	Seq Percent=46%

TCCATTCTCTGCTGGANGACGTGAGTAAACCTGAATCTTTGGAGTACGCTGGATAGCCCCCAGGCC	Seq Percent=66%

GGGGGAAAAAGNNNNNNNNNNNAGATCTGGAAAGGGTCGGGTTAGGAAAAAGTGTACAACGGGNNNGATTNNNGGGGGTGGCGGAGCATTAAAAAAAAAAAAAAAAAAAAAAAGTAATAAAATAAGAAGGAAAAAAAAAAAAAAGAAAAAA	Seq Percent=151%

GAGTGTNNNGNNNNNNNNNNNNTCTTAGNTGGTGGATCTCGACGCTCNCCCTTGATATTACANNNNTNNNNNNGACCTTGGATGTGGTAGCCGTTTCTCAAGCTCCCTCTCCGGAATCGAACTCTGATTCACCATCACCCGTGGTCACCAN	Seq Percent=151%

TCCAATCTCTTNNNNNNNNNNAGAAAAAACCTGAAACTTTGGAATACGCTGGATAACCTCCAANNNAAAANNNAAAAATAACGCGAACAAAACTAAAACCAAGGAACGAAACAAATCAGCCCGAAAACAGTCAAATTCAGAAAAGCCCAAA	Seq Percent=151%

CAGGAATTCAANNNNNNNNNNNTCTGTGGAACCCTTCTTCAAAGTCTTCACTGCTACTTTGATNNNTCCANNNCCAACTCCTAAGATGTCCACTGCTTTTC	Seq Percent=101%

CANGAATTCNNNNNNNNNNNNNTCTGTGGAACCCTTCTTCNAAGTCTTCACTGCTACTTTGANNNNTNCNNNNCCAACTCCTAAGATGTCCACTGCTTTTC	Seq Percent=101%

TGGTTCACACCCATGACGAACATGGGGGCATCAGCAGAGGGGGCAGAGATGATGACCCTTTTGGCTCCCCCCTGCAAATGAGCCCCAGCCTTCTCCATGGTGGTGAAGACGCCAGTGGACTCCACGACGTACTCAGCGCCAGCATCGCCC	Seq Percent=150%

TCCATTCTCTGCTGGANGANNTGAGTAAACCTGAATCTTTGGAGTACGCTGGATAGCCTCCAGGCC	Seq Percent=66%

TCCATTCTCTGNNNNNNNNNNTGAGNNAACCNNAATCTTTGGNGNACGCNNGATAGCCTCNANGNNAGNNANNTCGGANNANCAACGTGACGGGAAAGAGTCAAANACGGTGAANAACTCGNNGGACGCCGNNNAAATANNAAAAAAAANN	Seq Percent=151%

TCCATTCTCTGNNNNNNNNNNNGANNNAACCNNNATCTTTGNNNNACGCNNNATAGCCTCNNNGNNAGNNNNNTCGGNNNNNCGTCNTGACGGGAAAGANNGAAANTCGGTGTNNANATCGNNNGGAGACGNNNCATTANNAAAAAAAANN	Seq Percent=151%

TCCATTCTCNGNNNNNNGACGTGAATAAACCTGAATCTTTGGAGTACGCTGGATAGCCTCCGGNCCAG	Seq Percent=68%

CGAGCTGTGNTNNNNNNNNNNNACNNNTGTCNNNTCTGCATNNNNGTGANNTCGTTGATANNNNNNTNNNNNNGATCGNNNNGACCNNAGTGCAGGGTNNNGCAANNGATGTGNNAGAGCANNTCATGCAANNNGCTGANNAGCAGCAGNN	Seq Percent=151%

TCAATTCTCTGCTGGATGACGTGAGAAAACCTGAATATTTGGAGTACGCTGGAAAGCCTCCAGGCCAGAAAAAGAGAGTAACGAGAGAACACCTAAGGCCAAGGAGCGAGACATCTCGGCCCGAATGCAGTCAGATCGGAAGAGAGACGTG	Seq Percent=151%

GCTCCTAAGATCGGAAGAGCGACGTGTAGGGGAAGAGTAAACATCGGAGAAGAACTAGGAGGACGCCGTATAATTAAAAAAAAAAAAAGAAAAAAAAAAAAAAAAAGAAAAAAAAGAAAAAAAGAAATAAAAAAAAAATATAAAAAAAAAG	Seq Percent=151%

TACATTCTCTGCTGGATGAAGTGAGTAAACCTGAATATTTGGAGTACGCTGGAAAGCCTCAAAGACAGAAAAG	Seq Percent=73%

TCCATTCTCTGCTGNANNNNNTGAGTAAACCTGAATCTTTGGAGTACGCTGGATAGCCTCCAGGCNAGAAAG	Seq Percent=72%

CGGGCTGTGTTNNNNNNNNNNNCCCCTTGTCTCATCTGCTTGACGGTGAAGTCGTTGATGAGGNNNTGGTNNNGCTCGTTGAGGCCGCAGTGCAGGGTCACGCAGTCGCTGTGGAAGAGCAGGTCCTGCAGGGTGCTGACACGCTGCAGC	Seq Percent=150%

TCCATTCNCTGNTNNANGNNNNGAGTAAACATGAATCTTTGGAGTACGCTGGATAGCCTCCAGGNNAGAAAGNAAGAGTAGCGCGAGAACAGCTAAGGCCACAGAGCGAGACATCTCGGCCCGAATGCTGTCAGCTTCAGGAATGC	Seq Percent=146%

CGGGCTGTGNNNNNNNNNNNNNNCCATTGTATCATCTGCTNGACGGTGAAGTCGTTGATGAGNNNNNNGTNNNGCTCGTTGAGGACGCAGTGCAGGGTCACGCAGTCGCTGTGGAAGAGCAGGTCCTGCAGGGTGCTGACACGCTGCAGCN	Seq Percent=151%

TGGTTCACACCCANNACGAACATGGGGGGATCAGCAGAGGGNNNAGAAATGATGACACTTTTNGCTCCNNCCTGCAAATGAGCCCCAGCCTTCTCCATGGTGGTGAAAACGCCAGTGGACTCCACGACGTACTCAGCGCCAGCATCGCACN	Seq Percent=151%

TGGTTCACACACATGACGAACATGGGGGCATCAGCAGAGGGGGCAGAA	Seq Percent=48%

TCCATTCTCNNNNNNNNNNNNNGAGTGAACCTGAATCTTTNGCGCAGATCGAAAGAGCGTCGNNNNGNGANNNAGTGTACATCGGTGTAGATCTCGGTGGTCGCCGTATCATTAAAAAAAAAAAAAAAAAGATCAAAAGAGCTTAAGAAGN	Seq Percent=151%

ATCACCGTGCGGCACAGCTGGTCGCACAGTGGATCCTGGATGTCTTCGGGCCCTC	Seq Percent=55%

CGGGCTGTGTTNACNANNNNNGCCCCTTGTCTCATCTGCTTGACGGTGAAGTCGTTGATGAGGTNNTGGTTGNGCTCGTTGAGGCCGCAGTGC	Seq Percent=93%

CGAGCTGTGTTNNCNNNNNNNNCCACTTGTCTCATCTGCTTGACGGTAAAGTCGTTGATGAGGNNNTGGTNNNGCTCGTTGAGGCCGCAGTGC	Seq Percent=93%

TACATTATCAGCTGAGTGACGAGAGTAAACCTGAATCTTTGGAGAACNCTGGATGAACTCCAAGCAAGAAAGAGAGAGTAGCGCGAGCAAAGATAAGGCCACGGAGCGAGACATATCGGCCCGAATGCTGTCAGATTCAGGAATGCCCCAA	Seq Percent=151%

ACCATTCTCTGCTGGATGACGTGAGTAAACCTGAAGATGTGGAGTACGCTGGATAGACTCCAGCCAGA	Seq Percent=68%

TCCATTCTCTGCTGGATGACGTGAGTAAACCTGAA	Seq Percent=35%

TCCATTCTCTGCTGGATGACGTGAGTAAACCTGAATCTTTGGAGTACGCTGGATAGCCTCCAGGCCAGAAAGAGAGAGTAGCGCGAGCACAGCTAAGGCCACGGAGCGAGACATCTCGGCCCGAATGCTGTCGGCTTCAGGGATGCCCCNG	Seq Percent=151%

TCCATTCTCTGCTGGATGACGTGAGTAAACCTGAATCTTTGGAGTACGCTGGATAGCCTCCAGGCCAGAAAGAGAGAGTAGCGCGAGCACAGCTAAGGCCACGGAGCGAGACATCTCGGCCNGAATGCTGTCGGCTTCAGGGATGCCCCNG	Seq Percent=151%

TCCATTCTCTGNNNNNNNNNNNGAGTAAACCTGAATCTTTGGAGTACGCTGGATAGCCTCCAGNNNAGAA	Seq Percent=70%

TCCATTCTCNNNNGNNNNNNNNGAGTAAACCTGAATCTTTGGAGTACGCTGGATAGCCTCCAGNNNANAANNNGAGAGTAGCGCGAGCACAGCTAAGGCCACGCA	Seq Percent=105%

CGGGCTGTGTTCACNAGGAAGGCCCCTTGTCTCATCTGCTTGACGGTGAAGTCGTTGATGAGGTGGTGGTTGTGCTCGTTGAGGCCGCAGGCAGGG	Seq Percent=96%

TAGTAAACAAACATGGAGGAAAAGGGGGGGGAAGCAGAGGGGGAAGAAAAAAGGGAAGAATTAACACAGGAATACAAATGAGACCCAGCATTATAAATGGTAGAGAAAACGACAATGGAATAAAAGAAATAATCAGAGCCAGCATCGAAC	Seq Percent=150%

TCCATTCTCTGCTGGATGACGTGAGTAAACCTGAATCTTTGGAGTACGCTGGATAGCCTCCAGGCCAGAAAGAGAGAGTAGCGCGAGCACAGCTAAGGCCACGGAGCGAGACATCTCGGCCCGAATGCTGTCAGCTTCAGGAATGCCCCAA	Seq Percent=151%

TCCATTCTCTGCTGGATGACGTGAGTAAACCTGAATCTTTGGAGTACGCTGGATAGCCTCCAGGCCAGAAAGAGAGAGTAGCGCGAGCACAGCTAAGGCCACGGAGCGAGACATCTCGGCCCGAATGCTGTCAGCTTCAGGAATGCCCCAG	Seq Percent=151%

TGGTTCACACCCATGACGAACATGGGGGCGTCAGCAGAGGGGGCAGAGATGATGACCCTTTTGGCTCCCCCCTGCAAATGAGCCTCAGCCTG	Seq Percent=92%

CGGGCTGTGTTNACNANNNNNGCCCCTTGTCTCATCTGCTTGACGGTGAAGTCGTTGATGAGGTNNTGGTTNNGCTCGTTGAGGCCGCAGTGCAGGGTCACGCAGTCGCTGTGGAAGAGCAGGTCCTGCAGGGTGCTGACACGCTGCAGC	Seq Percent=150%

CGNGCTNNNNNNNNNNNNNNNNNCCCTTGTCTCATCTGCTNGACGGTGAAGTCGTTGATGAGNNNNNNNNNNNGCTCGTTGAGGCCGCAGTGCAGGGTCACACAGTCGCTGTGGAAGAGCAGGTCCTGCAGGGTGCTGACACGCTGCAGCN	Seq Percent=151%

TCNATNCTNNNNNNNNNNNNNNNNGTAAACCTGAATCTTTNNNNTACGCTGGATAGCCTCCANNNCNNNN	Seq Percent=70%

TCCATTCTCTGCTGGATGACGTGAGTAAACCTGAATCTTTGGAGTACGCTGGATAGCCTCCAGGCCAGAAAGAGAGAGTAGCGCGAGCACAGCTAAGGCCACGGAGCGAGACATCTCGGCCCGAATGCTGTCAGCTTCAGGAATACCC	Seq Percent=148%

CGGGCTGTGTTCACCAGGAAGGCCCCTTGTCTCATCTGCTTGACGGTGAAGTCGTTGATGAGGTGGTGGTTGTGCTCGTTGAGGCCGCAGTGCAGGGTCACGCAGTCGTTGTGGAGGAGCAGGTCCTGCAGGGTGCTGACACGCTGCAGC	Seq Percent=150%

GCGTTTGGTGAGATNANNNNNGCGTCGTGTAGGGAAAGAGTGTACATCGGTGTAGATCTCGGTGGNCGCCGTATCATTAAAAAAAAAAAAAAAAAAAAAAAAAAAAAAATAAAAGAAAAATAAACAACAAAAAAAACAAAATAAAAAAAAA	Seq Percent=151%

TGGTTCACACCNATNANNNNNATGGGGGCATCAGCGG	Seq Percent=37%

TGGTTCACACCCANNNCGAACATGNNNGCGTNNNCAGAGGGNNNNGAGANNNTGACCCTTNNNGCTCCNNCCTGCAANNNNNCCCCNGCCTTCTCCATGGTGGTGAAGACGCCNNTGGACTNNNCGACGTANNNAGCGCNAGCATCGCCNN	Seq Percent=151%

TCCATTCTCTGCTGGATGACGTGAGNAAACCNGAATCTTTGGAGTACGCTNGATAGCCTCCAGGCCAAAAC	Seq Percent=71%

TCCATTCTCTGATGGATGACGTGAGAAAACCTGAATCTTTGAAGTACGCTGGATAGCCTCCAGGCCAGAAAG	Seq Percent=72%

CGGGCTGTGTTCACAAGGAAGGCCCCTTGTCTCATCTGCTTGACGGTGAAGTCGTTGATGAGGTGGTGGTTGTGCTCGTTGAGGCCGCAGTGCAGGGTCTGC	Seq Percent=102%

TGGTTCACACCNANNANNNNNATGNNNGCGTNNGCAGAGGGGNCNGAGANNATGACCCTTNTNGNNCCNNCCNGCAAANNANCCCCNGCCTTCTCCATGGTGGTGNAGACGCCNNTGGACTNNACGACGTANNNAGCGCNNGCATCGCGNN	Seq Percent=151%

TCCATTCTCTGNNNNNNNNNNNGAGTAAAGCTGAATCTTTGGAGTACGCTGGATAGCCTCCGGNNNAAAA	Seq Percent=70%

TNCATTCTCTGCNNNNTGACGTGNGTAAACCTGAATCTTTGNNNTACGCCGGATAGCCTCCANGCCANNNG	Seq Percent=71%

TCTACCGTGCCAGACTAGAGTCAAGCTCAACAGGGTCTTCTTTTCCCGCTGATTCCGCCAAGCCCGTTCCCTTGGCTGTGGTTTCGCTGGATAGTAGGTAGGGACANTGGGAATCTCGTTCATCCATTCATGCGCGTCACTAATTAGATNA	Seq Percent=151%

TCCATTCTCTGNTGNANNNNNTGAGTAAACCTGAATCTTTGGAGTACGCTGGATAGCCTCCAGGNNAGAAANNGAGAGTAGCGCGAGCACAGCTAAGGCCACGGAGCGAGACATCTCGGCCCGAATGCTGACAGCTTCAGGAACC	Seq Percent=145%

TCCATTCTCTGCTGGATGACGTGAGTAAACCTGAATCTTTGGAGTACGCTGAATAGCCTCCAGGCCAGAAAGAGAGAGTAGCGCGAGCACAGCTAAGGCCACGGAGCGAGACATCTCGGCCCGAATGCTGTCAGCATC	Seq Percent=138%

CGGGCTGTGTTCANNANGNNNGCCCNTTGTCNNATCTGCTTGNCGGTGAANTCGTTGATGAGATGNTGNNGGTGCTCGNNGNGGCCGCAGGGCAGGGTCACGCAGTCGCTGTGGNAGAGCANNACCTGCAGGNTGCTGANNGGCTGCAGNN	Seq Percent=151%

CGGGCTGTGTTNANNANNNNNGCCNNNTGTCNNATCTGCTTGNCNGTGANNTCGTTGATGNGNTNNTGNNGGTGCTCGNNNNGGCCNCAGTGCAGGGTCACGCAGNCGCTGTGNNAGAGCANNTCCTGCAGNNNGCTGANNGGCTGCAGNN	Seq Percent=151%

TCCATTCTCTGCTNNAAGACGTGAGNNAACCNNAATCTTTGGNGNACGCNNGATAGCCTCNANGCCAGNNCGGAAGAGNNTCGTGTAGGGAAAGAGTGTACATCGGTGTAGATCNCGGTGGNNGCCGTATANNNAAAAAAAAAAAAATANN	Seq Percent=151%

CANGAANNNNNNNNNNNNNNNNNCTGTGGAACCCTTCTTCNAAGTCTTCACTGCTACTTTGANNNNNNNNNNNCCAACTCCTAAGATGACCA	Seq Percent=92%

TGGTTCACACCCATAACAAACATGGNGGCATCAGCAGAGCGGGATAAATCNGAAGAGAATCGTGTAGAGAAAGAGTGANNAACATAGTAGAACTAGCTAATCCAAGTATCAACANAAAAAANAACAAAATCANAACCAAGAGCTAAATANA	Seq Percent=151%

TCCATTCTCTGNTGNANGACGTGAGTAAACCTGAATCTTTGGAGTACGCTGGATAGCCTCCAGGCCAGAA	Seq Percent=70%

TCCATTCTCTGNTGNANNNNNTGAGTAAACCTGAATCTTTGGAGTACGCTGGATAGCCTCCAGGCNTAGAC	Seq Percent=71%

TGGATCTCGACGCTCTCCCTTCCTCACACTCCAGCCGTCTCTCTTAATCATGGCCTCAGTTCCGAAAACCAACAAAATAGAACCGCGGTCCTATTCCATTATTCCTAGCTGCGGAAACCAAGCGGCTCGGGCCTGCTTTGAACACTCTAAT	Seq Percent=151%

TGGTTCACACCCATGACGAACATGGGGGCATCAGCAGAGGGGGCAGAGATGATGAG	Seq Percent=56%

TCCATTCTCTGNNGNANNNNNTGAGTAAACATGAATCTTAGGAGTACGCTGGATAGCCTCCAGGNNAGAAAGNGAGAGTAGCGCGAGCACAGCTAAGGCCACGGAGCGAGACATATCGGCCCGAATGAGGTCAGCTTCAGCAATGCCCCAG	Seq Percent=151%

TCCATTCTCTGCTGGATGACGTGAGTAAACCTGAATCTTTGGAGTACGCTGGATAGCCTCCAGGCCAGAAAGAGAGAGTAGCGCGAGCACAGCTAAGGCCACGGAGCGAGACATCTCGGCCCGAATGCTGTCAGCTTCAGGAATGCCC	Seq Percent=148%

TCCATTCTCTGCTGGATGACGTGAGTAAACCTGAATCTTTGGAGTACGCTGGATAGCCTCCAGGCCAGAAAGAGAGAGTAGCGCGAGCACAGCTAAGGCCACGGAGCGAGACATCTCGGCCCGAATGCTGTCAGCTTCAGGAATGCCCCAG	Seq Percent=151%

CCACGCGTTTTTANNCGGTAAAGCGAGTGATTAGAGGTATTNNGNCCGAAACGATCTCAACCNATTCTNNAACTTTAAATGGGTAAGAAGCCCGGCCCCAAGACAGCGAGCCGGGCTTCTTACCCATTTAAATTCGAGATCGGAAGAGCNN	Seq Percent=151%

TCCATTCTCTGCTGGATGACGTGAGTAAACCTGAATCTTTGGAGTACGCTGGATAGCCTCCAGGCCAGAAAGAGAGAGTAGCGCGAGCACAGCTAAGGCCACGGAGCGAGACATCTCGGCCCGAATGCTGTCAGCTTCAGGAATGCCCCAG	Seq Percent=151%

TCCATTCTCTGCTGGATGACGTGAGTAAACCTGAATCTTTGGAGTACGCTGGATAGCCTCCAGGCCAGAAAGAGAGAGTAGCGCGAGCACAGCTAAGGCCACGGAGCGAGACATCTCGGCCCGAATGCTGTCAGCTTCAGGAATGCCCCAG	Seq Percent=151%

TCCATTCTCTGCTGGATGACGTGAGTAAACCTGAATCTTTGGAGTACGCTGGATAGCCTCCAGGCCAGAAAG	Seq Percent=72%

TCCATTCTCTGCTGNANGANNTGAGAAAACC	Seq Percent=31%

CGNGCTNTNNNNNNNNNNNNNNNCCCTTGTCTCATCTGCTNGACGGTGAAGTCGTTGATGAGNNNGNNGNNNNGCTCGTTGAGGCCGCAGTGCAGGGTCACGCAGTCGCTGTGGAAGAGCAGGTCCTGCAGGGTGCTGACACGCTGCAGCN	Seq Percent=151%

CGNGCNGTNNNNNNNNNNNNNNNCCCTTGTCTCATCTGCTNNANGGTGAAGTCGTTGATGAGNNNGNNNNNNNGCTCGTTGAGGCCGCAGTGCAGGGTCACGCAGTCGCTGTGGAAGAGCAGGTCCTGCAGGGTGCTGACACGCTGCNGCN	Seq Percent=151%

TCCATTCTCTGCTGNANGACGTGAGTAAACCTGAATCTTTGGAGTACGCTGGATAGCCTCCAGGCCAGAAAGAGAGAGTAGCGCGAGCACAGCTAAGGCCACGGAGCGAGACATCTCGGCCCGAATGCTGTCAGCTTCAGGAATGCCCCAG	Seq Percent=151%

TCCATTCTCTGCTGNANGACGTGAGTAAACCTGAATCTTTGGAGTACGCTGGATAGCCTCCAGGCNAGAAATAGC	Seq Percent=75%

TCCATTCTCTGCTNNATGACGTGAGTAAACCTGAATCTTTGGNGTACGCTGGATAGCCTCCGNCAAGAN	Seq Percent=69%

TNCATTCTCTNCNNNNTGACGTGNGTAAACCTGAATCTTCGNNNTACGCTGGATAGCCGCCANCCC	Seq Percent=66%

GAAAAGAAAAGAGAAGAAGAAAAGTAAGAGGAGATAGAAGAAAAAAAAAAAAACGAAAAAAAAAGAAAAGAAGAGAAAAAAAAAAGCAAAGACACAACCAAAAAAAAACAAGAGAAAAACAAAAAAAAAAAAAGAAAAAAAAGAAAACAAA	Seq Percent=151%

GGACATGGGAACGGAAGAGCGGAGTGTAGGGAAAGAGTGTACATCGGTGTAGATCTCGGTGGGAGAAGTAAAATTAAAAAAAAAAAAAAAAAAAAAAAAGAAAAGAAAAACAAGGAAGAGAAAAAAAAAGAAGAATAGAGAAAGAAATAAA	Seq Percent=151%

TGNTTCACANNNNNNNNNNNNNTGGGGGCATCAGCAGAGGGGGCAGAGATGATGACCCTTTTGNNNCCCCNNNGCAAATGAGCCCCAGCCTTCTCCATGGTGGTGAAGACGCCAGTGGACTCCACGACGTACTCAGCGCCAGCATCGCCCN	Seq Percent=151%

TGNTTCNNANNNNNNNNNNNNNNGGGGGCATCAGCAGAGGNGGCAGAGATGATGACCCTTTTGNNNCNCCNNNGCAAATGAGCCCCAGCCTTCTCCATGGTGGTGAAGACGCCAGTGGACTCCACGACGTACTCAGCGCCAGCATCGCCCN	Seq Percent=151%

TCCATTCTCTGCTGGATGACGTGAGTAAACCTGAATCTTTGGAGTACGCTGGATAGCCTCCAGCCAGA	Seq Percent=68%

GCNAAANNNNNNNNNNNNNNNNNTCGTGTAGTGAAAGAGTNTACATCGGTGTAGATCTCGGTNNNNNNCNNNNCATTAAAAAAAAAAAAAAAAAATAATAAGATGCAGCGAGAAGAAGATAAAGAAGTGAGAAAAGAAACAAGATAATAAN	Seq Percent=151%

TCCATTCTCTGNNNNNNNACGTGAGTAAACCTGAATCTTTGGAGTACGCTGGATAGCCCCCAGGCCAACAA	Seq Percent=71%

TCCATTCTCTGCTNNANGACGTGAGNNAACCNNAATCTTTGGNGNACGCNNGATAGCCTCNANGCCAGNAAGAGAAGANNGNAAGANCGTCGTGTAGGGAAAGAGTGTACATCGNTGTAAANNTCGGAGGTCNCCATATNNTTAAAAAANN	Seq Percent=151%

TCCATTCTCTGCTGGANGANNTGAGTAAACCTGAATCTTTGGAGTACGCTGGATAGCCTCCAGGCCTGAA	Seq Percent=70%

CGGGCTGTGTTCACNANGAAGGCCCCTTGTCTCATCTGCTTGACGGTGAAGACGTTGATGAGGTGNTGGGTGTGCTCGTTGAGGCCGCAGTGCAGGGTCACGCAGTCGCTGTGGAAGAGCAGGTCATGCAGGGTGCTGACACGCTGCAGC	Seq Percent=150%

TCCATTCTCTGCTGGATGACGTGAGTAAACCTGAATCTTTGGAGTACGCTGGATAGCCTCCAGGCCAGAA	Seq Percent=70%

TCCATTCTCTGCTNNANGNNNTGAGNAAACCNNAATCTTTGGAGTACGCTNGATAGCCTCAGACC	Seq Percent=65%

TCCATTCTCTGCTGNANGNNNTGAGTAAACCTGAATCTTTGGAGTACGCTGGATAGCCTCCAGGCCAGAA	Seq Percent=70%

TGGTTCACACNNNNNNCGAACATCACACGCGCGCGCGCGCGCGCCGCCCCCGCCGCTCCCGTNCACTNNNGACTGCCGGCGACGGCCGGGTATGGGCCCGACGCTCCAGCGCCATCCATTTTCAGGGCTAGTTGATTCGGCAGGTGANTTN	Seq Percent=151%

TCCATTCTCTGCTNNATGACGTGAGNNAACCNNAATCTTTGGNGNACGCNNGATAGCCTCCAGGCCAGNAAGAGAGAGNNGNGCGAGCACAGCTAAGGCCACGGAGCGAGACATNTCGGCCNNAATGCTGTCNGCTTCANNAATGCCCCNN	Seq Percent=151%

TCCATTCTCTGNNNNNNNNNNTGAGTAAACCTGAATCTTTGGAGTACGCTGGATAGCCTCCAGGNNGAAAAG	Seq Percent=72%

CAGGAATTCAATCNTCTCCTGGTCNNNGGAANNCTTCTTCAANGNCTTCNNTGCTACTTTNANTTCTCNNCTTCCAACNNNNAAGANGTCCACTGCTGTNNCTTCNNACACTTNNCCAAAGNNTCCACTTCNNAGCAAGNNATCGGAAANN	Seq Percent=151%

TCCATTCTCTNNNNNNTGACGTGAGTAAACCTGG	Seq Percent=34%

TCCATTCTCTGNTGNANNNNNTGAGTAAACCTGAGTCTTTAGAGTACGCTGGATAGCCTCCAGGCCAGAAAAAAAGAGTAACGCGAGCACAGCAAAATAGATCGGAAAAGCATCATATAGAGAAAGAATTACATCGATATAGATAACGAAG	Seq Percent=151%

TCCATTCTCTGAANGAGGACGTGAGNAAACCNNAATCTTTGGAGTACGCTNGATAGCCTCCAGGCCAGNAAGAGAGAGNNGCGCGAGCACAGCTAAGACCACGGAGATCGGAAGNGCGTCGNNTAGGGAAAGNGTGAACANCGGTGTAGNA	Seq Percent=151%

TCNATTNNNNNNNNNNNNNNNNNAGTAAACCTGAATCTTTNGAGTACGCTGGATAGCCTCCANNNNNNAN	Seq Percent=70%

TGGTTCACACACATGACGAACATGGGGGCGTCAGCAGAGGGGGCAGAGATGATGACCCTTTTGGCTCCCCCCTGCAAATGAGCCCCAGCCTTCTCCATGGTGGTGAAGACGCCAGTGGACTCCACGACGTACTCAGCGCCAGCATCGCCC	Seq Percent=150%

TACATTCTCCGCTGGATGACGTGAGTAAACATGAATCTTTGGAGTACGCTGGATAGCCTCCAGGCNAGAAAGAGAGAGTAGCGCGAGAACAGCTA	Seq Percent=95%

GGGTCTCGAAGNGCNCNNNNNCTCAAACTCCAAGCATCCCTCTTAAAAATAAGCTCAGGTCGGANNAACAAANAAAAAAAACAGCGGTCCTAAATCATATTTTCTAAATGAGGCAGGCAGAAAGGAAAAAAGGAGAGGAAGGGAAAAATAT	Seq Percent=151%

CTTGGCTGACTGCACANGANNGGGGGCAGCCCGCCTCCTCGGCCACATATGACCCCTCCACTGTTACAAGCAGCTGGGCCTGGGATTGCCTAG	Seq Percent=93%

ACNATTCTCNNNNNNNNNNNNNGAGTAAACCTGAATCTTTNGAGTACGCTGAATAGCCGCCGNNNNANGNNNNATCGGAAGAACGTCGTGTAGGGAGAGAGTGGACAACGGTGTAGATCTCGGTGGTCACCGTATAATTAAAAAAAAAAAN	Seq Percent=151%

AGNTTCACANNNNNNNNNNNNNNGGGGGCTTCAGCAGAGGNGGCAGAGATGATGAACCGTTGNNNNCNNNNNNGCAAATGAGCCCCAGCCTTCTCCATAGTGGTGAAAACGCCAGTGGACTCCACGACATACTCAACGCCAGCATCGACCN	Seq Percent=151%

AAAAAAATGAGATANAAAAAAGAAAAGGAAATAAAAGTAAAAAAAAAAATGAATCTCCTCCAAAAAAAAAGAGAGAAAAATCTTCTTGTACGGAAATAGTATACATATTTGAAAATCTCAGAGGGAGAAATAACATAAACCAAAAAAAAAA	Seq Percent=151%

AAAATAAAATGCTGNATGAAGTGAGTAAAAATGAATCTTTGGAATACAGTGGATCTCCTCCAGGACAAAAGATAGGAAGAAATACTAGTATCGACCACGTGTACACGAATGTAGATCTCAGAAGGAGCCGTATCAAGAAAAAAAAAAAAAA	Seq Percent=151%

TGGTTCACACCCATGANGAACATGGGGGCGTCAGCAGAGGGGGCAGAGATGATGACCCTTTTGGCTCCCCCCTGCAAATGAGCCCCAGCCTTCTCCATGGTGGTGAAGACGCCAGTGGACTCCACGACGTACTCAGCGCCAGCATCGCCC	Seq Percent=150%

TCCANTCTCTGCNNNNTGACGTGNNTAAACCTGAATCTTTGNNNNACGCTGGATAGCCTCCANGCCANNNAG	Seq Percent=72%

TCCATTCTCTGNTGNANNNNNTGAGTAAACCTGAATCTTTGGAGTACGCTGGATAGCCTCCAGGCNAGAAAGAGAGAGTAGCGCGAGCACAGCTAAGGCCACAGAGCAAGACATCTCGGCCCGAATGCTGTCAGCTTCAGGAATGCCCAAG	Seq Percent=151%

TCCATTCTCTGCTGGANGACGTGAGTAAACATGAATCTTTGGAGTACGCTGGATAGCCTCCAGGCCAGAAAGAGAGAGTAGCGCGAGCACAGCCAAGGCCACGGAGCGAGACATCTCGGCCCGAATGCTGTCAGCTGCAGGAATC	Seq Percent=145%

TGGTTCACACCCATGACGAACATGGGGGCATCAGCAGAGGGGGCAGAGATGATGACCCTTTTGGCTCCCCCCTGCAAATGAGCCCCAGCCTTCTCCATGGTGGTGAAGACGCCAGTGGACTCCACGACGTACTCAGCGCCAGCATCGCCC	Seq Percent=150%

CGGGCTGTGTTNNNNNNNNNNGCCCCTTGTCTCATCTGCTTGACGGTGAAGTCGTTGATGAGGTNNTGGTTGNGCTCGTTGAGGCCGCAGTGCAGGGTCACGCAGTCGCTGTGGAAGAGCAGGCCCTGCAGGGTGCTGACACGCTGCAGC	Seq Percent=150%

TGGTTCACANNNNNNNNNAACATGGGGGCGTCAGCAGAGGNNNNAGAGATGATGACCCTTTTNNGCTNNNNNCTGCAAATGAGCCCCAGCCTTCTCCATGGTGGTGAAGACGCCAGTGGACTCCACGACGTACTCAGCGCCAGCATNNCCN	Seq Percent=151%

TGGTTCACANNNNNNNNGAACATNGGGGCGTCAGCAGAGGNNNNAGAGATGATGACCCTTTTNNGCTNNNNNCTGCAAATGAGCCCCAGCCTTCTCCATGGTGGTGAAGACGCCAGTGGACTCCACGACGTACTCAGCGCCAGCATNNCCN	Seq Percent=151%

TCCATTCTCTGCTGGANGANNTGAATAAACCTGAATCTTTGGAGTACACTGGATAGCCTCCAGGCCAGAAAGAGAGAGTAGCGCGAGCACAGCTAAGGCCACGGAGCGAGACATCTCGGCCCGAATGCTGTCAACTTCAGGAATGCCCCAG	Seq Percent=151%

TCCATTCTCTGCTGGATGANNTGAGTAAACCTGAATCTTTGGAGTACGCTGGATAGCCTCCAGGCNAGAAAGAGAGAGTAGCGCGAGCACAGCTAAGGCCACGGAGCGAGACATCTCGGCCCGAATGCTGTCAGCTTCAGGAATGC	Seq Percent=146%

GGCTGCATGAAGTTTTNACNNGGTAAAACTCATTGTATTTCCACTTCTGTAGCGCAACCCAA	Seq Percent=62%

CGGGCTGTGTTNACNANNNNNGCCCCTTGTCTCATCTGCTTGACGGTGAAGTCGTTGATGAGGTGNTGGTTGTGCTCGTTGAGGCCGCAGTGCAGGGTCACGCAGTCGCTGTGGAAGAGCAGGTCCTGCAGGGTGCTGACACGCTGCAGC	Seq Percent=150%

TCCATTCTCTGNNNNNNNNNNNGAGTAAACCTGAATCTTTGGAGTACGCTGGATAGCCTCCAGNNNAAAGN	Seq Percent=71%

TCNATTNNCTGNNNNNNNNNNNGAGTAAACCTGAATCTTTGGAGTACACAGATCGGAAGAGCNNNNTGTAGGNAAAGAGTGTACATCGGTGTAGATCTCGGTGGTCGCCGTATCATTAAAAAAAAAAAAAAAAAAATATAAAAGTAAATCN	Seq Percent=151%

TTCGCGTCGTGNAGNGNNNNNGTGTACATCGGTGTAGATCTCGGTGGTCGCCGTATCATTAAAAANAAAAAAAGAAGAAAAAAGAAAGAAAAAGGTAGGAAAGAAAAAAAAAAAGGAAAAAGAAAGAAAGAAAGTAAGGAAAAATGGGAGT	Seq Percent=151%

TGNTTCNNANNNNNNNNNNNNNNGGGGGCATCAGCAGAGGNGGCAGAGATGATGACCCTTTTNNNNNNCNNNNGCAGATGA	Seq Percent=81%

TCNATTNNCNNNNNNNNNNNNNNAGTAAACCTGAATCTTTNGAGTACGCTGGATAGCCTCCANNNNNNNNNNNGAGAGTAGCGCGAGCACAGCTAAGGCCACGGAGCGAGACATCTCGGCCCGAATGCTGTCAGCTTCAGGAATCAGATCN	Seq Percent=151%

TGNTTCNNANNNNNNNNNNNNNNGGGGGCGTCAGCAGAGGNGGCAGAGATGATGACCCTTTTNNNNNNNNNNNGCAAATGAGCCCCAGCCTTCTCCATGGTGGTGAAGACGCCAGTGGACTCCACGACGTACTCAGCGCCAGCATCGCCCN	Seq Percent=151%

TCCATTCTCTGCTGGATGACGTGAGTAAACCTGAATCTTTGGAGTACGCTGGATAGCCTCCAGGCCTGGAA	Seq Percent=71%

AAAAAAAAACCCACAAANNNNACAAGCTAACACCAACTTCCGAACCAAAACATACGATAAACTCANTCAATAAACCAAATAATACAAACACCAAAAAAAAAAACACACACCTAACAAAAAAATATACCCACATATCTACACAAAAACACAA	Seq Percent=151%

TCCATTCTCTGCNNNNTGACGTGAGTAAACCTGAATCTTTGGAGTACGCTGGATAACCTCCAGGCCANAAAGAGAGAGTAGCGCGAGCACAGCTAAGGCCACGGAGCGAGACATCTCGGCCCGAATGCTGTCAGCTTCAGGAATGCCCAAN	Seq Percent=151%

TCNATTCTCNNNNNNNNNNNNNGAGTAAACCTGAATCTTTGGAGTACGCTGGATAGCCTCCAGNNNANAANNNGAGAGTAGCGCGAACACAGCTAAGGCCACGGAGCGAGACATCTCGGCCCGAATGCTGTCAGCTTCAGGAATCAGATCN	Seq Percent=151%

TNGTTGCCAAATGCCTCGTCATCTAATTAGTGACGCGCATGAATGGATGAACGAGATTCCCACTGTCCCTACCTACTATCCAGCGAAACCACAGCCAAGGGAACGGGCTTGGCGGAATCAGCGGGGAAAGAAGACCCTGTTGAGCTTGA	Seq Percent=149%

TCNATTNNCNNNNNNNNNNNNNNAGTAAACCTGAATCTTTNGAGTACGCTGGATAGCCTCCANNNCNNANNNNGAGAGTAGCGCGAGCACAGCTAAGGCCACGGAGCG	Seq Percent=108%

AAAGAAAGTCAGGTAGAGGCAGAGTNTGCAAAGGTAAAGATATCGGTAGGNAGCGTAACATTAAAAGAAAGAGGAAAAAAAAAAAGTAAAAGAGAAGAAAAAAGAAAATAAAAAAAAAAAANAAAAAAAGAGAAAATAGTAGAAATAGGNA	Seq Percent=151%

TCCATTCTCTGCTGGATGACGTGAGTAAACCTGAATCTTTGGAGTACGCTGGATAGCCTCCAGGCCAGTCAG	Seq Percent=72%

TCCATTCTCTGNTGNANNNNNTGAGTAAACCTGAATCTTTGGAGTACGCTGGATAGCCTCCAGGCNAGAAAGAGAGAGTAGCGCGAGCACAGCTAAGGCCACGGAGCGAGACATCTCGGCCCGAATGCTGTCAGCTTCAGTAATGCCCCAG	Seq Percent=151%

ACCATTCTCTGNTNNANNNNNTGAGTAAACCTGAATCTTTGGAGTACGCTGGATAGCCTCCAGGNNAGAAAGAGAGAGTAGCGCGAGCACAGCTAAGGCCACGGAGCGAGACATCTCGGCCCGAAAGATGTCAGC	Seq Percent=135%

ACCATTNNCNNNNNNNNNNNNNGAGTAANCCTGAATCTTTNNNNTACNCTGGATAGCCTCAANNNNANNNNNNNAGAGTAGCGCGAGCACAGATAAGGCCACGGAGCGAGACATCTCGGCCCGAAAGCTGTCAGCTTCAGGAATGCCNANN	Seq Percent=151%

TGGTTCACAACNANNANNNNNATGGGGGCATAAGCAGAGGGGGCAGAGATAATGACCATTATAGNNCCCCCCNGCAAATGAGCCACAGACTTATCCATGATGGTGAAGACGAAAGTGGACTCCACGAAGTACTCAGCGCCAGCATCGCCA	Seq Percent=150%

TCCATTCTCTGNNNNNNNNNNNAAGTAAAACTGAATCTTTGGAGTACGCTGGATAGCCTACAGNNNAGAANNNAAAAGTAGCGCGAGCACAGCTAAAGCCACGGAGCGAGACATCTCGGCCCGAATGCTGACAGCTTCAGCAATC	Seq Percent=145%

TCCATTCTCTGCTGNANGANNTGAGTAAACCTGAATCTTTGGAGTACGCTGGATAGCCTCCAGGCCAGAAAGAGAGAGTAGCGCGAGCACAGCTAAGGCCACGGAGCGAGACATCTCGGCCCGAATGCTGTCAGCTTCAGGAATGCCCCAG	Seq Percent=151%

TACATTCTCTGCTGGATGACGTGAGTAAACCTGAATCTTTGGAGTAAGCTGGATAACCGCCAAGACAGGAAGAGAGAGTAGAGCGAGCACAACTAAGGCCACGGAGCGAGACACCTCGGCACGAATGCTGTCAGCTTCAGGAATGCC	Seq Percent=147%

TGGTTCACACCNAANANNNNNGAGCTCCAGATGATGGCTGAACATCACCTGAGGCAACAGCACAANGGAGAGGTGACTGAGAAAGCTTCTGAGAGCACAGGGACCCAGGAAACGTGACCACCCAGGATCAAAGACACGGAAGTGGAGTCAA	Seq Percent=151%

CATGGCTTGCAGCTNCNGGNNCTTCTGGCGGTAT	Seq Percent=34%

TTGTTCACACCCATGANGAACATGGGGGCGTCAGCAGAGGGGGCAGAGATGATGACCCTTTTGGCTCCCCCCTGCAAATGAGCCCCAGCCTTCTCCATGGTGGTGAAGACGCCAGCGGACTCCACGACGTACTCAGCGCCAGCATCGCCC	Seq Percent=150%

TTGTTCACACCCATNANGAACATGGGGGCGTCAGCAGAGGGGGCAGAGATAATGACCCTTTTGGCTCCCCCCTGCAAATGAGCCCCAGCCTTCTCCATGGTGGTGAAGACGCCAGTGGACTCCACGACGTACTCAGCGCCAGCATCGCCC	Seq Percent=150%

CANAAAGANNNNNNNNNNNANNNGGAAAGAGAAGACCCAANNACTCACAACAGTCACAACCCNNNANNNNNNNAGAACCGTAAAAAAAAACAAACAAATCACACGCAAAGCTACAACGAACACAAATAAAAAAAAAACTAAAATATANAAN	Seq Percent=151%

TGNTTCACANCNNNNNNNNNNNTGGGGGCGTCAGCAGAGGGGGCAGAGATGATGACCCTTTTGNNNCCCCNNNGCAAATGAGCCCCAGCCTTCTCCATGGTGGTGAAGACGCCAGTGGACCCCACGACGTACTCAGCGCCAGCATCGCCC	Seq Percent=150%

TTGTTCACACCCATGACGAACATGGNGGCGTNAGCAGAGGGGGCAGAGATGATGACCCTTTTGGCTCCCCCCTGCAAANNAGCCCCAGCCTTCTCCATGGTGGTGAAGACGCCAGTGGACTNCACGACGTACTCAGCGCCAGCATCGCCN	Seq Percent=150%

TGGTTCACACCCATGACGAACATGGGGGCATCAGCAGAGGGGGCAGAGATGATGACCCTTTTGGCTCCCCCCTGCAAATGAGCCCCAGCCTTCTCCATGGTGGTGAAGACGCCAGTGGACTCCACGACATACTCAGCGCCAGCATCGCCC	Seq Percent=150%

TCCATTCTATGCTGGATGACGTGAGTAAACCTGAATCTTTGGAGTACGCTGGATAGCCTCCAGGCCACAAAG	Seq Percent=72%

CGGGCTGTGGTNACNANNNNNGCCACTTGTCTCATCTGCTTGACGGTGAGGTCGTAGATGAGGTNNTGGTTGNGCTCGTTGAGGCCGCAGTACAGGGTCACGCAGTCGCTGTGGAAGAGCAAGTCCTGCAGGGTGCTGACACGCTGCAGCG	Seq Percent=151%

AAGGCTGTAGTNNNNNNNNNNNCCACTTGTCTCATCTGATTGACGGTGAGGTCGTTAATGAGGNNNTAGTTNNGCTCGTTGAGACCGAAGTACAGGGTCACACAGGCGCTGTAGAAGAGCAAGTCCGGCAGAGAGATGACACGCTGCAGAG	Seq Percent=151%

TCCCTTCTCTGNAGNANNNNNTGAGTAAACATGAACAATAGGAGTACGCAGGATAGCCTATAGGCNCGAAAGAGAGAGTAGCGCGAGCACAGCTAAGGCCACGGAGCGAGAGAAATCGGCAAGAAGGAAGAAAGAATCAGGAATGTCCAAG	Seq Percent=151%

TCCATTCTCTGCTNNATGACGTGAGNNAACCTGAATCTTTGGNGNACGCNNGATAGCCTCCANGCCAGNNAGAGAGAGTAGCGCGAGCACAGCTAAGGCCACGGAGCGAGACATCTCGGCNNGAATGCTGTNANCTTCAGGAATGCCCCNN	Seq Percent=151%

TCCATTCTCTGCTGGANGANNTGAGTAAACCTGAATCTTTGGAGTACGCTGGATAGCCTCCAGGCCAGT	Seq Percent=69%

TCCATTCTCTGNTGNANNNCGTGAGTAAACCTGAATCTTTGGAGTACGCTGGATAGCCTCCAGGCCAGAAAGAGAGAGTAGCGCGAGCACAGCCAA	Seq Percent=96%

TCNATTCTCNGNNNNNNNNNNNGAGTAAACCTGAATCTTTGGAGTACGCTGGATAGCCTCCAGNNNAGAA	Seq Percent=70%

TCCATTCTATGATGNANGNNNAGAGTAAACCTGAATCTTTGTCGTACGCTGGATAGCCTCCAGGCNATCAAGAGAGAGTAGCGCGAGCACAGCTGAGGCCACGGAGCGAGACATCTCGGCCCGAATGCTGTCAGCTTAAGGAATGCCCCAG	Seq Percent=151%

TCCATTCACTGNTGNANNNNNTGAGTAAACCTGAAACTTTAGAGTACGCTGGATAGCCTACAGGCNGGAA	Seq Percent=70%

TCCATNCTNNNNNNNNNNNCGTNNGTAAAACTGAAACTTTNNNNAACACTGGATAGCCTACANNCCNNNNNNAGAGAGTAGCGCGAGCACAGCTAAGGCCACGGAGCGAGACATCTCGGCCCGAATGCTGCCAGCTTAAGATCGGANNAGN	Seq Percent=151%

TCCATTCTCTGCTGNGTGACGTGAGTAAAAC	Seq Percent=31%

TCCATTCTCTGCTNNATGACGTGAGNNAACCNNAATCTTTGGNGTACGCNNGATAGCCTCNANGCCAGNN	Seq Percent=70%

CGNGCTGTGNTNNNNNNNNNNNCCCCTTGTCTCATCTGCTTGACGGTGAAGTCGTTGATGAGGNNNTGGTNNNGCTCGTTGAGGCCGCAGTGCAGGGTCACGCAGTCGCTGTGGAAGAGCAGGTCCTGCAGGGTGCTGACACGCTGCAGC	Seq Percent=150%

ACCATAATATGNTGNTNNNNNTGAGTAAACCTGAATCTTTGGAGTACGCTGGATAGCCTCCAGACNGTA	Seq Percent=69%

TCNATTCTCNNNNNNNNNNNNNGAGTAAACCTGAATCTTTGGAGTACGCTGGATAGCCTCCANNNNANANNNNTCAGAAGAGCGTCGTGTAGGGAAAGAGTGTACATCGGTGTAGATCTCGGTGGTCGCCGAATCATTAAAAAAAAAAAAN	Seq Percent=151%

TCCATTCTCTGNTGNANNNNNTGAGTAAACCTGAATCTTTGGAGTACGCTGGATAGCCTCCAGGCNAGAAAGAGAGAGTAGCGCGAGCATAGCTAAGGCCACGGAGCGAGACATCTCGGCCCGAAT	Seq Percent=126%

TCCATTCTCTGNTGNANNNNNTGAGTAAACCTGAATCTTTGGAGTACGCTGGATAGCCTCCAGGNNAGAAAGNGAGAGTAGCGCGAGCACAGCTAAGGCCACGGAGCGAGACATCTCGGCCCGAATGCTGTCAGCTTCAGGAATGCCCCAG	Seq Percent=151%

TCCATTATCTGCTNNNTGACGTGAGTAAACCTGAATCTTTGGAGTACGCTGGATAGCCTCCAGGACAGAAAGAGAGAGTAGCGCGAGCACAGCTAAGGCCACGGAGCGAGACATCTCGGCCCGAATGCTGTAAGCTTCAGGAATGCCCCAN	Seq Percent=151%

AACGTCGTGTAGNNNNAGAGTGTCGTCAGGAA	Seq Percent=32%

TCCATTCTCTGCTGGAAGACGTGAGNAAACCNGAATCTTTGGAGTAGCC	Seq Percent=49%

TCAATGAGANNNNNNNNGACGAGNGTAAACCTAAATCTTTNNNNTACGCTGGATAGCCTCCANNCCANNNNAAG	Seq Percent=74%

CGGGATGTGTTCACCAGGAAAGCCACTTGTCTCATCTGCTTGACGGTGAAGTCGTTGATGAGGAAGTGGCTGT	Seq Percent=73%

TCNATTCTCNGNNNNNNNNNNNTAGGAAACCTGAATCTTTGGAGTACGCTGGATAGCCTCCAGNNNAGCAN	Seq Percent=71%

GNAATTCTCTGANNNNTGACGTGNGAAAAAGTAAATAATTGNNNNGAAAAGAATAGACAAAANGACANNNAAAGAGAGTAAAGACGAGTAGGGAAAGAGAGTACATAGGAGTAGATAAAGGAGGAAGAAGTATAATAAAAAAAAAAAAAAN	Seq Percent=151%

TCCATTCTCTGATGAATAACGAGAGTAAACGTGAATATTTGGAATAANCTGGATAGCCTCAAAGCAAGAAAAAGAGAGTAGCGCGAGCACAGCTAAGGCCACGGAACGAGACATATAGGCCAGAATGCAGTAAGATACAGGAATCAGAACG	Seq Percent=151%

AGGGATGAGATCAACGGGAAGGAGCGGTGTCTAATCTGCTTGACGGTAAAGACGTTGATGAGGAGGTGGTTGGGCTCGTTGAGACCGCAGTGCAGGGTCACGCAGTCGCTGTGGAAGAGCAGGTCCTGAAGAGTGCTGACACGCTGCAGC	Seq Percent=150%

TCCATTCTCTGCTGNANGANNTGAGTAAACCTGAATCTTTGGAGTACGCTGGATAGAAGGCAGGCCAGAAAGAGAGAGTAGGGAGAGAACAGCTAAGGCCACGGAGCGAGACGTCTAGGCCCGAATGCTGTCAGCTTCAGGAATGCCCCAT	Seq Percent=151%

TCNATTNNNNNNNNNNNNNNNNNAGTAAACCTGAATCTTTNGAGTACGCTGGATAGCCTCCANNNNANNNNNNGAGAGTAGCGCGAGCACAGCTAAGGCCACGGAGCGAGACATCTCGGCCCGAATGCTGTCAGCTTCAGGAATGCCCAAN	Seq Percent=151%

TGGTTCACACCNAANANNNNNATGGAGGCATCAGCAGAGGGGGCAGAGATAATAACACTTTTGGCNCCCCCCTGCAAATGAGCCCAAACCTTCTCCATGGTGGTGAAGACGCCAGTAGACTCCACGACGTACTCAGCACCAGCATCGCCC	Seq Percent=150%

TCCATTCTCTGCTGGATGACGTGAGTAAACCTGAATCTTTGGAGTACGCTGGATAGCCTCCAGGCCAGAAAGAGAGAGTAGCGCGAGC	Seq Percent=88%

TCCATTCTCTGCTGGANGANNTGAGTAAACCTGAATCTTTGGAGTACGCTGGATAGCCTCCAGGCCAGGAG	Seq Percent=71%

TCCATTCTCTGNNNNNNNNNNNGAGTAAACCTGAATCTGTGGAGTACGCTGGATAGGCTCCAGNNNAGAAANNGAGAGTAGCGCGAGCACAGCTAAGGCCACGGAGCGAGACATCTCGGCCAGAATGCTATCAGCTTCAGGAATGCCCCAG	Seq Percent=151%

AANAAANNANNNNNNNNNNNNNNGAAGAATCAACGACGACNAAAGGAAGGAATGGGATAACGNNNNGNNNNNNACAAAAACACAAGAAGCACAGCGCCGGAACAAAAAGATAAAATATAAAACCAAAAAAAAAAAAAATAAAGAAAAAGAN	Seq Percent=151%

CGNGCTNNNNNNNNNNNNNNNNNGAATTGTCTCATCTGCTNGACGGTGAAATCGTTGATGAGNNNNNNNNNNNGCTCGTTGAGGCCTCAG	Seq Percent=90%

TCCATTCTATGATGGATGACGTGAGTAAACCTGAATCTTTGGAGTACTG	Seq Percent=49%

TGGTTCACACCCATGACGAACATGGNGGCATNAGCAGAGGGGGCAGAGA	Seq Percent=49%

TCCATTCTCTGCTGGATGACGTGAGTAAACCTGAATCTTTGGAGTACGCTGGATAGCCTCCAGGCCAGTAA	Seq Percent=71%

CGGGCTGTGNTNNNNNNNNNNNCCCCTTGTCTCATCTGCTTGACGGTGAAGTCGTTGATGAGGNNNTGGTNNNGCTCGTTGAGGCCGCAGTGCAGGGTCACGCAGTCGCTGTGGAAGAGCAGGTCCTGCAGGGTGCTGACACGCTGCAGC	Seq Percent=150%

AAAGAAAAAAAAGAAGAAGGAAAAAAGGGAGAAGGAGAAGAAGAAGAAGAAAAAGAAAAAAAAAAAGAAAAAGAAAGAGAAAAGAGAAAAAAAAAAGAAAAAAAAAAAAAAGAGAAAAAAAAAAAAAAAAAAAAAAAAGGAAAAAAATAAA	Seq Percent=151%

TGNTTCACANNNANNANNNNNNTGGGGGCATCAGCAGAGGGGGCAGAGATGATGACCCTTTGGNNNCCCCNNNCAAATGAGCCCCAGCCTTCTCCATGGTGGTGAAGACGCCAGTGGACTCCACGACGTACTCAGCGCCAGCATCGCCCCA	Seq Percent=151%

TGGTAAACACCNATNANNNNNATGGGGGCATCAGCAGAGGGGGCAGAGATGATGACACTTTTGGCNCCCCCCTGCAAATGAGCCCCAGCCTTCTCCATGGTGGTGAAGACGCCAGAGGACTACACGACGTACTCAGCGCCAGCATCGCAC	Seq Percent=150%

TCCATTCTCTGCTGNATGACGTGAGTAAACCTGAATCTTTGGAGTACGCTGGATAGCCTCCAGGCCAGAAAGAGAGAGTAGCGCGAGCACAGCTAAGGCCACGGAGCGAGACATCTCGGCCCGAATGCTGTCAGCTTCAGGAATGCCCCAA	Seq Percent=151%

TCCATTCTCNGNNNNNNNNNNNGAGTAAAACTGAATCTTGGGAGTACGCTGGATAGCCTCCAGNNNAGAANNNAAGAGTAGCGCGAACACAGCTAAGGCCACGGAGCGAGACATCTCGGCCCGAAAGCTGACAGCTTCAGGAATGCC	Seq Percent=147%

TGGTTCACACCCANGACGAACATGGNGGCGTNNGCAGAGGGGGCAG	Seq Percent=46%

TGGTTCACACCCATGANNNNNATGGGGGCGTCAGCAGAGGGGGCAGAGATGATGACCCTTTTGGCNCCCCCCAGCAAATG	Seq Percent=80%

TCCATTCTCTGNNNNNNNNNNNGAGTAAACCTGAATCTTTGGAGTACGCTGGATAGCCTCCAGNNNAGT	Seq Percent=69%

TCCATTCTCTGCTGGANGACGTGAGTAAACCTGAATCTTTGGAGTACGCTGGATAACCTCCAGGCCAGAAAGAGAGAGTAGCGCGAGCACAGCTAAGGCCACG	Seq Percent=103%

TCCATTCTCTGNNNNNNNNNNNGAGTAAACCTGAATCTTTGGAGTACGCTGGACAGCCTCCAGNNNAGAAAN	Seq Percent=72%

TCCATTCTCTGCTGGACGANNTGAGTAAACCTGAATCTTTGGAGTACGCTGGATAGCCTCCAGGCCAGAA	Seq Percent=70%

AGGGCTGTGTTNANNANGNNNNCCCCTTGTCTCATCTGCTTGACGGTGAAGTAGTTGATGAGGTNNTGGTTGNGATAGTTGAGGCAGCAGAGCAGGGACACGAAGACGAAGAGGAAGAGCATGAAAAGCAGGGTGAGGACAAGAAGCAGC	Seq Percent=150%

TGGTTCACACCCATGACGAACATGGGGGCGTCAGCAGAGGGGGCAGAGATGATGACCCTTTTGGCTCCCCCCTGCAAATGAGCCCCAGCCTTCTCCATGGTGGTGAAGACGCCAGTGGACTCCACGACGTACTCAGCGCCAGCATCGCCC	Seq Percent=150%

TGGTTCACACACATGACGAACATGGNGGCGTNAGCAGAGGGGGCAGAGATNATGACCCTTTTGGCTCCCCCCTGCAAANNAGCCCCANCCTTCTCCATNGTGGTGANGACGCCAGTGGACTNCACGACGTACTCAGCGCCNGCATCGCCN	Seq Percent=150%

TCCATTCTCTGCTGGATGACGTGAGTAAACCTGAATCTTTGGAGTACGCTGGATAGCCTCCAGGCCACAT	Seq Percent=70%

TCCATTCTCTGCTGGANGACGTGAGAAAACCTGAATATTTGGAGTACGCTGGATAGCCTCCAGGTAAGCAATATCGGAAGAGCGTCGAGAAGGGAAAAATGTACATCGGTAAAAATCACGATGTACGACGAATCAATAAAAAAAAAAAAAA	Seq Percent=151%

TCCATTCTCTGCTGGANGACGTGAGTAAACCTGAATCTTTGGAGTACGCTGGATAGCCTCCAGGCCACTAAG	Seq Percent=72%

TCCATTCTCTGCTGGATGACGTGAANAAACCTGAATCTTTGGAGTACGCTGGATAGCCTCCAGGCCAGAAAGAGAGAGTAGCGCGAGCACAGCTAAGGCCACGGAGCGAGACATCTCGGCCNGAATGCTGTCAGCTTCAGGAAAGCCCCNG	Seq Percent=151%

TCNATTCTCNGNNNNNNNNNNNGAGTAAACCTGAATCTTTGGAGTACGCTGGATAGCCTCCAGNNNAGAANNNGCG	Seq Percent=76%

TNGTTCACACCCATGACGAACATGGGGGCATCAGCAGAGGGGGCAGANATGATGACCCTTTTGGCTCCCCCCTGCAAATGAGCCCCAGCCTTCTCCATGGTGGTGAAGACGCCAGTGGACTCCACGACGTACTCAGCGCCAGCATTACCC	Seq Percent=150%

TCCATTCTCTGCTGGATGACGTGAGTAAACCTGAATCTTTGGAGTACGCTGGATAGCCTCCAGGCCAGAAAGAGAGAGTAGCGCGAGCACAGCTAAGGCCACGGAGCGAGACATCTCGGCCCGAATGCTGTCAGCTTCAGGTATGCCC	Seq Percent=148%

TCCATTCTCTGCTGGATGACGTGAGTAAACCTGAATCTTTGGAGTACGCTGGATAGCCTCCAGGCCACAC	Seq Percent=70%

TCCATTCTCTGCTGGATGANNTGAGTAAACCTGAATCTTTGGAGTACGCTGGATAGCCTCCAGGCCAGAAAGAGAGAGTAGCGCGAGCACAGCTAAGGCCACGGAGCGAGACATCTCGGCCCGAATGCCGTCAGCT	Seq Percent=136%

CGNGCTGTGNNNNNNNNNNNNNCCCCTTGTCTCATCTGCTNGACGGTGAAGTCTTTGATGAGNNNNTNGNNNNGCTCGTTGAGGCCGCAGTGCAGGGTCACGCAGTCGCTGTGGAAGAGCAGGTCATGCAGGGTGCTGACACGCTGC	Seq Percent=147%

TCCATTCTCTGCTGGATGACGTGAGTAAACCTGAATATTTGGAGTACGCTGGATAGCCTCCAGGCCAGAAAGAGAGAGTAGCGCGAGCACAGCTAAGGCCACGGAGCGAGACATCTCGGCCCGAAAGCTGTCAGCTTCAGGAATGCCC	Seq Percent=148%

AGAGCTGTGTTCACCANGAAGGCCCCTTGTCTCATCAGCTTGACGGTGAAGTCTTTGATGAGGAGGTGGTTGTGCTCGTTGAGGCCGCAGTGAAGGGTCACGCAGTCGCTGTGGAAGAGCAGGTCCTGCAGGGTGCTGACACGCTGCAGC	Seq Percent=150%

AGGGCTGTGTTCACNANGANNGCCCCTTGTCTCATCTGCTTGACGGTGAAGTCGTTGATGAGGTGGTGGTTGTGCTCGTTGAGGCCGCAGTGAAGGGTCACGCAGTCGCTGTGGAAGAGCAGGTCATGCAGGGTGCTGACACGCTGCAGC	Seq Percent=150%

TCCATTCTCTGCTNGATGACGTGAGNNAACCNNAATCTTTGGNGTACGCNNGATAGCCTCCAGGCCAGNAAGAGAGAGNNNCGCGAGCACAGCTAAGGCCNCGGANNGAGACANNTCGGCCNNAATGCTGTNNGCTTCANNAAGCCCCANN	Seq Percent=151%

ACCATTCTCGNCNNNNTGACGTGAGTAAACCTGAATCTTTGAAGTACGCTGGATAGCCTCCANTAAGNN	Seq Percent=69%

TGNTTCNNANNNNNNNNNNNNNTGGGGGCGTCAGGAGAGGNGGCAGAGATGAGGAAAATTTTNNNNNNNNNNNGGAAATGAGAAAAAGCCTTCTCCATGGTGGTGAAGAAGCCAGAGGACTCGACGACGTACTCAGCGTCAGCAGATNGGN	Seq Percent=151%

TCNATTNNCNNNNNNNNNNNNNGAGTAAACCTGAATCTTTNGAGTACGCTGGATAGCCTCCANNNNNNNNN	Seq Percent=71%

TCCATTCTATGCTGGANGANNTGAGTAAACCGGAATCAGATAGGAAGAGCGTCGTGTAGGGACAGNGCGTACATCGGTGTAGATCTCGGTGGTCGCCGTATCATTAAAAAAAAAACAAAAAAAAAAAAAAAGAAACAAAAAAAAGAAGAAA	Seq Percent=151%

TCCATTCTCTGNTGNANNNNNTGAGTAAACCTGAGGCGTTGGAGTACGCTGGAGAGAATCAAGGNNAGAAAGNGAGAGTAGCGAGAGCACAGCTAAGGCCACGGAGCGAGACATCACGGCCCGAATGCTGTCAGCTTCAGGGATCAGATAG	Seq Percent=151%

TCCATTCTCTGNTGNANNNNNTGAGTAAACCTGAGTCGTGGGAGTACGCTGGATAGAATCAAGGNNAGAAANNGAGAGTAGCGAGAGCACAGCTAAGGCCACGGAGCGAGACATCACGGCCCGAATACTGTCAGCTTCAGGGATC	Seq Percent=145%

TCCATTCTCTGNNNNNNNNNNNGAGTAAACCTGAGGCGGGGGAGTACGCTGGAGAGAATCAAGNNNAGAANNNGAGAGTAGCGAGAGCACAGCTAAGGCCACGGAGCGAGAAATCACGGCCCGAATGCTGTCAGCTTCAGGGATC	Seq Percent=145%

TCCATTCTCTGNTGNANNNNNTGAGTAAACCTGAATCTTTGGAGTG	Seq Percent=46%

TCCATTCTCTGNNNNNNNNNNNGAGTAAACCTGAATCTGTGGAGTACGCTGGATAGAACCAAGNNAAGATNNNAAGAGCGTCGTGAAGGGAAAGAGAGTACATCGGTGAACATCTAGGATGTGTCCGTATCATTAAAATAAGAAAAAAAAN	Seq Percent=151%

TAAATTCTCTGCNNNNTGAAGTGAGTAAACCTGGATCTTTGGAGTACGCTGGATGGCCTCCANGCCGNANAAAG	Seq Percent=74%

CGGGCTGTGTTCACCAGGAAGGCCCCCTGTCTCTCA	Seq Percent=36%

TCCATTCTCTGCTGGANGANNTGAGTAAACCTGAATCTTTGGAGTACGCTGGATAGCCTCCAGGCCAGAAAGAGAGAGTAGCGCGAGCACAGCTAAGGCCACGGAGCGAGACATCTCGGCCCGAATGCTGTCAGCTTCAGAAATACCCCAA	Seq Percent=151%

TCCATGCTCTGCTGGGNGANNTGAGTAAACAGGAGTCTTTGGAGTACGCGGGGTAGACTCCAAGCNAGAA	Seq Percent=70%

CGGGGTGTGTTNNANNNNNNNNCCCNNTGTANNAGCTGCTTGNCGGTGANNTCGCTGATGNNNNNNTGNTNNNGCTCGNNNNGGAGNNAGTGCAGGGTNANGCAGNNGCTGTGNNAGAGCANNTCATGCAGNNGGCTGANNCGCTGCAGN	Seq Percent=150%

TGGTTCACACCNNNNNNNNNNNTGGGGGCGTCAGCAGAGGGGGCAGAGATCGGAAGAGCGTCGNNNAGGGNNNGAGTGTACATCGGTGTAGATCTCGGTGGTCGCCGTATCATTAAAAAAAAAAAAAAAAAAAAAAAGAAAAAAAAAAAAN	Seq Percent=151%

TCAATTCTCTGCTGGCNGCNNAGAGTAAACCTGAATCTTTGGAGTACGCTGGATAGCCTCCAAGCNACACATAGAGAGTAGCGCGAGCACAGCTAAGGCCACGGAGCGAGACATCTCGGCCCGAATGCTGTCAGCTTCAGGAATGCCCCAA	Seq Percent=151%

TCCATTCAATTCTGGATGACGTGAGTAAAACTGAATCTTTGGAGTAAGCTGGATAGCCTCCATAACAGAAAT	Seq Percent=72%

TCCATTCTCTGCTGNATNNNNTGAGTAAACCTGAATCTTTGGAGTACGCTGGATTGCCTCCAGANNGGAAGANCGTCGTGTAGGGAAAGATTGTACATCGGTGTAGATCTCGGTGGTCGCCGTATCATTAAAAAAAAAAAAAAAAAAAAAA	Seq Percent=151%

TGGTTCACACCCANNACGAACATGGNNGCGTCAGCAGAGGGGNCAGAGANNATGACCCTTTNNGCTCCNCCCTGCAAATGAGCCCCAGCCTTCTCCATGGTGGTGAAGACGCCNNTGGACTNCACGACGTANNCAGCGCCAGCATCGCCNN	Seq Percent=151%

TCCATACAATTCTGGATGACGTGAGTAAAACTGAATCTTTGGAGTAAGCTGGATAGCCTCCATTACAGAAATAGAGAGTAGCGCGAGCACAGCTAAGGCCACGGAGCGAGACATCTCGGACCGAATGCTGTCAGCATAAGATCGGAATAT	Seq Percent=150%

TCCATTCTCTGCTGGATGACGTGAGTAAACCTGAATCTTTGGAGTACGCTGGATAGCCTCCAGGCCAGAAAGA	Seq Percent=73%

CANGAATTCNNNNNNNNNNNNNTCTGTGGAACCCTTCTTCAAAGTCTTCACTGCTGCTTTGANNNNTNCNNNNCCAACTCCTAAGATGTCCACTGCTGTTCCTTCATACACTTCTCCAAAGGCTCCACTTCCCAGCAAGAGACGCAGNGTN	Seq Percent=151%

ACCCTCAACTTCTTNCNGACGTTCGTAAACCTGAATAAAGCTCTTACGCTGGATAGCCTCCATCCCCCTCT	Seq Percent=71%

TCCATTCTCTGCTGGATGACGTGAGTAAACCTGAATCTTTGGAGTACGCTGGATAGCCTCCAGCAAGAA	Seq Percent=69%

TCCATTCTCTGNTGNANNNNNTGAGTAAACCTGAATCTTTGGAGTACGCTGGATAGCCTCCAGGNNAGTAAA	Seq Percent=72%

AAAATAAAGNNNNNNNAAAAAATATGTAATAAAACGCAATANTNAAAAATGATGTAATGAAANGGAGNNNNTGGAGTAAAAAATATAAGTAAAGAAGTAGAAATAGGGTTGTAGAGATAACCAAGAAAGTCAAAATGAAACAAAAGNNAAN	Seq Percent=151%

TANATTNNCNNNNNNNNNNNNNNAGTAAGCCTGAATCAAGNAAGGAAGAGCGTCGTGTAGGGANNNNGTGNNNATCGGTGTAGATCTCGGTGGTCGCCGTATCATTAAAAAAAAAAAAAAAATTAAAGAAAAATAAGAAAGAAGAANNAAN	Seq Percent=151%

TCCATTCTCTGNNNNNNNNNNTGAGTAAACCTGAATCTTTGGAGTAGATCGGAAGAGCGTCGTNNNGGGANNNAGTGTACATCGGTGTAGATCTCGGTGGTCGCCGTATCATTAAAAAAAAAAAAAAAAGAAAAGGAAGAGATGAATCAAN	Seq Percent=151%

TGGTTCACACCNATNANNNNNATGGGGGCGTCAGCAGAGGGGGCAGAGATCGGAAGAGCGTCGNNNAGGGNNNGAGTGTACATCGGTGTAGATCTCGGTGGTCGCCGTATCATTAAAAAAAAAAAAATAGTAAAGAGAATACAGGAGAAAA	Seq Percent=151%

TTCATTCTCTGCAGGATGACGTGAGTAAACCTGAATCTTTGGAGTACGCTGGATAGCCTCCAGGCAGGA	Seq Percent=69%

TCCACTCTCTGCTGGANTACGTGAGTAAACCTGAATCTTTGGAGTACGCTGGATAGCCTCCAGGCCAGAAAGAGAGAGTAGCGCGAGCACAGCTAAGGCCACGGAGCGAGACATCTCGGCCCGATTGCTGTC	Seq Percent=132%

TCCATTCTCTGCTGGATGACGTGAGTAAACCTGAATCTTTGGAGTACGCTGGATAGCCTCCAGGCCAGAAAG	Seq Percent=72%

TCNATTCTCNNNNNNNNNNNNNGAGTAAACCTGAATCTTTNGAGTACGCTAGATAGCCTCCANNNNANNNN	Seq Percent=71%

TCCATTCTCTGCTGGATGACGTGAGTAAACCTGAATCTTTGGAGTACGCTGGATAGCCTCCAGGCAAGAGC	Seq Percent=71%

TGGTTCACACCCATGACGAACATGGNGGCATCAGCAGAGGGGGCGGAGATGATGACCCTTTTGGCACCCCCCTGCAAATGAGCCCCAGCCTTCTCCATGGTGGTGAAGACGCCAGTGGACTCCACGACGTACTCAGCGCCAGCATCGCCN	Seq Percent=150%

GCCATTCTCTGNNNNNNNNNNTGAGTAAACATGAATCTTTAGAATACGCTGGATAGCCTCCATNNNC	Seq Percent=67%

TCCATTCTCTGCTGGATGACGTGAGTAAACCTGAATCTTTGGAGTACNCTGGATAGCCTCCAGGCNAGAAAGAGAGAGTAGCGCGAGCACAGCTAAGGCCACGGAGCGAGACATCTCGGCCCCAATGC	Seq Percent=128%

TGGTTCACACCCATGACGAACATGGGGGCGTCAGCAGAGGGGGCAGAGATGATGACCCTTTTGGCTCCCCCCTGCAAATGAGCCCCAGCCTTCTCCATGGTGGTGAAGACGCCAGTGGACTCCACGACGTACTCAGCC	Seq Percent=138%

TCCATTCTCTGCTGNANGNNNTGAGTAAACATGAATCTTTGGAGTACGCTGGATAGCCTCCAGGCNAGCA	Seq Percent=70%

TCCATTCTCTGCTGNANGNNNTGAGTAAACCTGAATCTTTGGAGTACGCTGGGAAGAATCAAGGCNAGAGAATT	Seq Percent=74%

TGGTTCAACAANTANCNNNNNTGGGGGCATCAGCGGAGGGGGCAGAGATGATGACCATTTTGGCNNCCCCCTGCAAATGAGCCCCAGCCTTCTCCATGGTGGTGAAGACGCCAGTGGACTCCACGACGTACTCAGCGACAGCATGGCCCCA	Seq Percent=151%

TCCATTCTCTGCTGGATGACGTGAGTAAACCTGAATCTTTGGAGTACGCTGGATAGCCTCCAGGCCAGAAAGAGAGAGTAGCGCGAGCACAGCTAAGGCACTGG	Seq Percent=104%

TCCATTCTCTGCTGGATGACGTGAGTAAACCTGAATCTTTGGAGTACNCTGGATAGCCTCCAGGCNATCAG	Seq Percent=71%

TGNTTCNNANNNNNNNNNNNNNTGGTGACATCAGATCGGAAGAACGTCGTGTAGGGAAAGAGNNNNCNTNNNNGTAGATCTCGGTGGTCGCCATATCATTAAAAAAAAAAAAAACAAAAAACAAAAGAAAGAGAAAAACATACTAAAAAAN	Seq Percent=151%

TCCNTTCTCTGCTNNATGACGTGANNNAACCTGAATCTTTGNNGNACGCNGGATAGCCTCCANGCCANNAAGAGAGAGTAGCGCGAGCACAGCTAAGGCCACGGAGCGAGACATCTCGGCNNGAATGCTGTCANCTTCAGCATGCCCAGNN	Seq Percent=151%

TGGTTCACACCCANNACGAACATGGGGGCATCAGCAGAGGGGNCAGAGATGATGACCCTTTTNGCTCCNCCCTGCAAATGAGCCCCAGCCTTCTCCATGGTGGTGAAGACGCCAGTGGACTCCACGACGTACTCAGCGCCAGCATCGCCNN	Seq Percent=151%

TCCATTCTCTGCTGNATGACGTGAGTAAACCTGAATCTTTGGAATACGCTGGATAACCTCCAGGCTA	Seq Percent=67%

CGGGCTGTGTTCACCANGAAAGCCCCTTGTCTCATCTGCCTGACGGTG	Seq Percent=48%

TCCATTCTCTGNTGGANNNNNTGAGTAAACCTGAATCTTTGGAGTACGCTGGATAGCCTCCAGGCNAGAAAGAGAGAGTAGCGCG	Seq Percent=85%

TCNATTCNCNNNNNNNNNNNNNGAGTAAACCTGAATCTTTGGAGTACGCTGGATAGCCTCCAGNNNANANNNNGAGAGTAGCACGAGCACAGGTAAGGCC	Seq Percent=100%

TCCATTCTCTGCTGGATGACGTGAGNAAACCNGAATCTTTGAAGTACGCTGGATAGCCTCCAGGCCAGAAAGAGAGAGTNGCGCGAGCACAGATAAGGCCACGGAGCGAGACATCTCGGCCCGAATGCTGTCAGCTTCAGGAATCAGATNG	Seq Percent=151%

TCNATTCTCNNNNNNNNNNNNNGAGTAAACCTGAATCTTTGGAGTACACTGGATAGCCTCCAGNNNANANNNNGAGAGAAGCGCGAGCACAGCTAAGGCCACGGAGCGAGACATATCGGCACGAATGCTGTCAGCTTCAGGAAAGCCCAGN	Seq Percent=151%

TGGTTCACACCCANGACGAACATGGGGGCATCAGCAGAGGGGGCAGAGATGATGACCCTTTTGGCTCCNCCCTGCAAATGAGCCCCAGCCTTCTCCATGGTGGTGAAGACGCCAGTGGACTCCACGACGTACTCAGCGCCAGCATCGCCN	Seq Percent=150%

TGGTTCACACCCATGACGAACATGGGGGCATCAGCAGAGGGGGCAGAGATGATGACCCTTTTGGCTCCCCCCTGCAAATGAGCCCCAGCCTTCTCCATGGTGGTGAAGACGCCAGTGGACTCCACGACGTACTCAGCGCCAGCATCGCCN	Seq Percent=150%

TGGTTCACACCCATGACGAACATGGGGGCGTCAGCAGAGGGGGCAGAGATGATGACCCTTTTGGCTCCCCCCTGCAAATGAGCCCCAGCCTTCTCCATGGTGGTGAAGACGCCAGTGGACTCCACGACGTACTCAGCGCCAGCATCGCCC	Seq Percent=150%

TCNATTNNCNNNNNNNNNNNNNNAGTAAACCTGAATCTTTNGAGTACGCTGGATAGCCTCCANNNNANANNNNGAGAGTAGCGCGAGCACAGCTAAGGCCACGGAGCGAGACATCTCGGCCCGAATGCTGTCAGCTTCAGGAATGCCNCAN	Seq Percent=151%

TCCATTCTCTGCTGGATGACGTGAGNAAACCNGAATCTTTGGAGTACGCTNGATAGCCTCCAGGCAAGNAGAGATCGGNNNAGCGTCNTGTAGGGAAANAGTGTACNTCGGTGTAGATCTCNGTGGTCGCCGTATCATTAAAAAAAAAANA	Seq Percent=151%

TCCATTCTCTGCTGGANGACGTGAGTAAACCTGAATCTTTGGAGTACGCTGGATAGCCTCCAGGCCAATAA	Seq Percent=71%

TCCATTCTCTGCTNGATGACGTGAGTAAACCTGAATCA	Seq Percent=38%

TCCATTCTCTGNTGNANNNNNTGAGTAAACCTGAATCTTTGGAGTACGCTGGATAGCCTCCTGGCNAGAA	Seq Percent=70%

GCNTCGNNTNNNNNNNNNNNNNNGCGTAAGG	Seq Percent=31%

CAAAAAACAAGAGAAGAAGAAAGAAGGAGAAATACATGAACAAACACAAAAAGCACGAAAAAAACAAAAAATAATAAAACAACAGACAAAACCACAAATCACTAAGCAAAGAGTGAAGAAAGAATGAAAAAAAGAACCAACAAAAAAGCA	Seq Percent=150%

TCCATTCTCTGNNNNNNNNNNNGAGTAAACCTGAATCTTTGGAGTACGCTGGATAGCCTCCAGNNNAGAAANNGAGAGTAGCGCGAGCACAGCTAAGGCCACGGAGCGAGACATCTCAGCCCCAG	Seq Percent=125%

TCCATTCTCTGCTGGATGACGTGAGTAAACCTGAATCTTTGGAGTACGCTGGATAGCCTCCAGGCCAGAA	Seq Percent=70%

TGGTTCACACCNATNANNNNNATGGGGGCGTCAGCAGAGGGGGCAGAGT	Seq Percent=49%

TCCATTCTCTGNNNNNNNNNNTGAGTAAACCTGAATGCAAGATCGGAAGAGCGTCGGGTAGGGANNGAGTGANCATCGGTGTAGATCTCGGTGGTCGCCGTATCATTAAAAAAAAAAAAAAAAAAAAGAAGAAGAAACAAAAGAAAGAAAA	Seq Percent=151%

CGGGCTGTGTTNNNNNNNNNNNCCCCCTGTCTCATCTGCTTGACGGTGAAGTCGTTGATGAGGTNNTGGTTNNGCTCGTTGAGGCCGCAGTGCAGGGTCACGCAGTCGCTGTGGAAGAGCAGGTCCTGCAGCGTGTCAGCACCCTGCAGGA	Seq Percent=151%

CGGGCTGTGTTNNNNNNNNNNNCCCCCTGTCTCATCTGCTTGACGGTGAAGTCGTTGATGAGGNNGTGGTNNNGCTCGTTGAGGCCGCAGTGCAGGGTCACGCAGGCGCTGTGGAAGAGAAGGTCCTGCAGCGTGTCAGCACCCTGCAGGA	Seq Percent=151%

TCCAATCTCTGCTGGGAGGCGTGGGAAAAACTGGATCTTTGGGATAAACTTGGTGACCTCCAAGCNGACAAAGATCGGAAAAACGGCGGGTAGGGAAAGAGTGTACAACGGTGTAGATATCGGTGGTCTCCGGATCAATAAAAAAAAAAAA	Seq Percent=151%

TCNATTCTCNNNNNNNNNNNNNGAGTAAACCTGAATCTAGATCGGAAGAGCGTCGTGTAGGGANNNAGTGNNNATCGGTGTAGATCTCGGTGGTCGCCGTATCATTAAAAAAAAAAAAAAAAAAGAAAAAAAAAAACAAAAAAAATAAAAN	Seq Percent=151%

TCCATTCTCTGNNNNNNNNNNNGAGTAAACCTGAATCTTTGGAGTACGCTGGATAGCCTCCAGGNNAGAAANNGAGAGTAGCGCGAGCACAGCTAAGGCCACGGAGCGAGACATCTCGGCCCGAATGCTGTCAGCTTCAGGAATGCCC	Seq Percent=148%

CAGCTCTGGATCTCGANGCTCTCCCTTCCTCACACTCCAGCCGTCTCTCTTAATCATGGCCTCAGTTCCGAAAACCAACAAAATAGAACCGCGGTCCTATTCCATTATTCCTAGCTGCGGTATCCAGGCGGCTCGGGCCTGCTTTGAACA	Seq Percent=150%

TCCATTCTCTGCTGNATGNNNTGAGTAAACCTGAATCTTTGGAGTACGCTGGATAGCCTCCAGGCNAGAAAGAGAGAGTAGCGCGAGCACAGCTCAGGCCAC	Seq Percent=102%

TGGTTCACACCCATGACGAACATGGGGGCGTCAGCAGAGGGGGCAGAGATGATGACCCTTTTGGCTCCCCCCTGCAAATGAGCCCCAGCCTTCTCCATGGTGGTGAAGACGCCAGTGGACTCAACGACGTACTCAGCGCCAGCATCGCCC	Seq Percent=150%

TGGTTCACATCCATGANGAACATGGGGGCATCAGCAGAGGGGGCAGAGATGATGACCCTTTTGGCTCCCCCCTGCAAATGAGCCCCAGCCTTCTCCATGGTGGTGAAGACGCCAGTGGACTCCACGACGTACTCAGAGCCAGCATCGCCC	Seq Percent=150%

TGGTTCACATCCATGANGAACATGGGGGCATCAGCAGAGGGGGCAGAGATGATGACCCTTTTGGCTCCCCCCTGCAAATGAGCCCCAGCCTTCTCCATGGTGGTGAAGACGCCAGTGGACTCCACGACGTACTCAGAGCCAGCATCGCCC	Seq Percent=150%

TCCATTCTCTGNTGNANNNNNTGAGTAAACCTGAATCTTTGGAGTACGCTGGATAGCCTCTAGGCN	Seq Percent=66%

TGGTTCACACCNATNANNNNNATGGGGGCATCAGCAGAGGGGGCAGAGATGATGACCCTTTTGGCNCCCCCCTGCAAATGAGCCCCAGCCTTCTCCATGGTGGTGAAGACGCCAGTGGACTCCACGACGTACTCAGCGCCAGCATCGCCCG	Seq Percent=151%

TCCATTCTCTGCTGGANGACGTGAGTAAACCTGAATCTTTGGAGTACGCTGGATAGCCTCCAGGCCAGAAAGAGAGAGTAGCGCGAGCACAGGC	Seq Percent=94%

CAGNAATTCAATCNNCTCCTGGTCTGTGGAACCCTTCTTCANNGNCTTCACTGCTACTTTGANTTCTCNACTTCCAACTCCTAAGATGTCCACTGCTGTTCCTTCATACACTTCTCCAAAGGCTCCACTTCCCAGCAAGAGACCCAGATNN	Seq Percent=151%

AATAAAAAAAAAGCAGCCTAAACTACCCAGAAACCCGCAAAACAAGAAGAAAAACAAGCATAAACACCCGCACAGACAAGAAAACAAACACCCACTTCTAGCATCTGATGTTTCTGACTAACATGAAGCTGGATAGGTTTTTACGTTAGAA	Seq Percent=151%

CGGGCTGTGCTCNNNNGGAAGGCNCCTTGTCTCATCTGCTTNNNGGTGAAGTCGTTGATGAGNAGGTNNNTGTGCTCGTTGAGGCCGGCGTGCAG	Seq Percent=95%

AAATAAAAAAAAGAGAAAAGAAAGTGGAAAGAAAAGGAAAAAGAAAGAGAAGAAGAGAAGGAGATAAAAGAGAGGAGAAAAAGAAAAAGTAAAGAGAAGAGAAAAGAATGGATAGGGAGTAAAGAAAATAAAAAGGAGGTAAAAAAGAAAA	Seq Percent=151%

CANGAANNCNNNNNNNNNNNNNTCTGTGGAACCCTTCTTCAAAGTCTTCACTGCTACTTTGANNNNTNCNNNNCCAACTCCTAAGATGTCCACTGCTGTTCCTTCATACACTTCTCCAAAGGCTCCACTTACCAGCAA	Seq Percent=138%

TCCATTCTCTGNTGGANNNNNTGAGTAAACCTGAATCTTTGGAGTACGCTGGGTAGCCTCCAGGCNAGAAAGAGAGAGTAGCGCGAGAACAACTAAGGCC	Seq Percent=100%

TCCATTCTCTGNTGGANNNNNTGAGTAAACCTGAATCTTTGGAGTACGCTGGGTAGCCTCCAGGCNAGAAAGAGAGAGTAGCGCGAGAACAACTAAGGCC	Seq Percent=100%

CGGGCTGTGTTCNNNNGGAAGGCCCCTTGTCTCATCTGCTTGACGGTGAAGTCGTTGATGAGGTGGTGGTTGTGCTCGTTGAGGCCGCAGTAC	Seq Percent=93%

TCCATTCTCTGCTGGAGGAAGTGAGTAAACCTGAATCTTTGGAGTACGCTGGATAGCCCCCAGACN	Seq Percent=66%

CGGGCTGTGTTGACCGGTGAGGCCCCTTGTCTCATCTGCTTGACGGTGAAGTCGTTGATGAGGGGGTTGTGGTGCCCGTTGAGGCCGCAGTGCAGGGTCACGCAGTCGCTCTGGCAAAGCAGGTCCTGCAGGGTGCTGACACGATGCAGT	Seq Percent=150%

TCNATTANCNNNNNNNNNNNNNGAGTAAACCTGAAAAGATCGGAAGAGCGTCGTGTAGGGAANNNNGNTNNNNCGGTGGAGATCTAGGTGGTCGCCGAATAATTAAAAAAAAAAAAAAAAAAAAAAAAAAAAAAAAAAGAGGAGAAAAAAN	Seq Percent=151%

CAGGAATTCAATCTTCNCCTGGTCTGTGGAACCCTTCTTCAAAGTCTTCACTGCTACTTTGATTTCTCCACTTCCAACTCCTAAGATGTCCACTGCTGTTCCTTCATACACTTCTCCAAAGGCTCCACTTCCCAGCAAA	Seq Percent=139%

CGNGCNNNNNNNNNNNNNNNNNNCCCTTGTCTCATCTGCTNGACGGTGAAGTCGTTGATGAGNNNNNNNNNNNGCTCGTTGAGGCCGCAGTGCAGAAGA	Seq Percent=99%

TCCATTCACTGCTGGATGACGAGAGTAAACCTGAATCTTTAGAGTACGCTGGATAACCTCCAGGCCAGAAAGAGAGAGTAGCGCGAACACAGCTAAGGCCACGGAGCGAAACATCTCGGCCCGAATGCTGTCAGCTTCAGGAAAGCCAGAA	Seq Percent=151%

TCCATTCACAGNTGNANNNNNAGAGTAAACCTGAATCTTTGGAGTACGCTGGATAACCTCCAGGCNAGAAAGAGAGAGGAGCGCGAACACAGCTAAGGCCACGGAGAAAAACATCTCGGCCCAAAAGCTGTCAGCTTCAAGAAAGCCCCAG	Seq Percent=151%

AGGTTCACANCNNNNNNNNAAATGAGGGCGTCAGCAGAGGGGGAAGAGATGATGACAATTTTGNCTCCCCNNNGCAAAAGAGCCCCAGCCTTCTCCATGGTGGTGAAAACGCCAGTGGACTACACGACATAATCAGCGCCAGCATCGCCCN	Seq Percent=151%

TCCATTCTCTGCTGNATGACGTGAGTAAACCTGAATCTTTGGAGTACGCTGGATAGCCTCCAGGACAGAA	Seq Percent=70%

TGGTTCACACNCNNNNCGAACATNGGGGCGTCAGCAGAGGGNGNAGAGATGATGACCCTTTTNGCTCNNNCCTGCAAATGAGCCCCAGCCTTCTCCATGGTGGTGAAGACGCCAGTGGACTCCACGACGTACTCAGCGCCAGCATCNNCCN	Seq Percent=151%

GCCATTCTCTGNNNNNNNNNNTGAGTAAACCTGAATCTTTGGAGTACGCTGGATAGCCTCCAGNNNAGAAGNNG	Seq Percent=74%

TCCATTCTCTGCTGGANGACNTTAGTAAACCTGAATCTTTGTAGTACGCTGGAGAGAATACAGGCCAGAAAGATAGGAAGAGAGGAGTGTAGGGAACGAGTGGAGATAGTTGTACAGGACGTTGGTCGGCGTATGAGTCAGAAAAAAAAAA	Seq Percent=151%

TCCATTCTCTGCTGNANGANNTTAGTAAACCTGAATCTTTGTAGTACGCTGGAAAGAATACAGGCCAGAAAGATAGGAAGAGAGAAGTGTAGGGAACGAGTGCAGATAGTTGTACAGAACGTTGGTCGACGTATGAGTCAGAAAAAAAAAA	Seq Percent=151%

TCNATTCTCNGNNNNNNNNNNNTAGTAAACCTGAATCTTTGTAGTACGCTGGGTAGAATACAGNNCAGCGNNNAACGGAAAAAAGAAGTGAAGGGACAGAGAGTAAAGAGGTGTAGAGATGTGTGGTCGCCGTATCGTTAGAAAAAAAAAN	Seq Percent=151%

TCCCATTTCTGGTGGGTGAAGGTGGTAAAACTTGATCTTTTTAGGAAGGTGGGTAGCCGCCAGGGGC	Seq Percent=67%

CGGGCTGGGTTNACNGNNNNNGCCCATTGTCTAATCTGATTGACGGTGAAGTCGTTGATGAGGTGNTGGTTATGCTCGTTGAGGCCGCAGTGCAGGGTCACGCAGTCGCTGTGGAAGAGCAGGTCCTGCAGGGTGCTGACACGCTGCAGC	Seq Percent=150%

CGGGCAGTGTTNACNGNNNNNGCCCATTGTGTAATCTGCTTGACGGTGAGGTCGTTGATGAGGTNNTGGTTGTGCTCGTTGAGGCCGCAGTGCAGGGTCACGCAGTCGCTGTGGAAGAGCAGGTCCTGCAGGGTGCTGACACGCTGCAGC	Seq Percent=150%

TCCATTCTCNGNNNNNNNNNNNGAATAAACCTG	Seq Percent=33%

TCCATTCTCTGCTGGANGANNTGAGTAAACCTGAATCTTTGGAGTACGCTGGATAGCCTCCAGGCCAGACA	Seq Percent=71%

TGGTTCACACCCATNANGANNATGGGGGCATCAGCAGAGGGTGCAG	Seq Percent=46%

TCCATTCTCTGNNNNANNNNNTGAGTAAACCTGAATCTTTGGAGTACGCTGGATAGCCTCCAGNNNAGCG	Seq Percent=70%

TGGTTCACACCCATGACGAACATGGGGGCATAAGAAGAGGTGGCAGAGATGAAGACCCTTATGGCTCCCTCCTGAAAAAGAGACCAAGCCTTCTCCATGGTGGTGAAGAAGGCAGTGGAGTCAAAGAGCAACACAGCGGCAGGATCGCCC	Seq Percent=150%

TCCATTCTCTGNTGNANNNNNTTAGTAAACCTGAATCTTTGTAGTACGCTGGATAGCCTCCAGGCNAGAAAGAGAGAGTAGCGCGAGCACAGCTAAGGCCACGGAGCGAGACATCTCGGCCCGAATGCTGTCAGCTTCAGGAATGACCCAG	Seq Percent=151%

CGGGCTGTGTTCACCANGAAGGCCCCTTGTCTCATCTGCTTGACGGTGAAGTCGTTGATGAGGTGGTGGTTGTGCTCGTTGAGGCCGCAGTGCAGGGTCACGCAGTCGCTGTGGAAGAGCAGGTCCTGCAGGGTGCTGACACGCTGCAGC	Seq Percent=150%

TGGTTCACACCCATGANGAACATGGGGGCGTCAGCAGAGGGGGCAGAGATGATGACCCTTTTGGCTCCCCCCTGCAAATGAGCCCCAGGCTTCTCCATGGTGGTGAAGACGCCAGTGGACTCCACGACGTACTCAGCGCCAGCATCGCCC	Seq Percent=150%

CGGGCTGTGTACACCAAGAAAGCCACTTGTCTCATCAGCTAGACGGTGAAGTCGTTGATGAGGTGGTAGTTGTGCTCGTTGAAGCCGCAGTGCAGGCTAACGCAGTCGCTGAGGAAGAGCAGGACCAGCAGGATGCTGACACACTGCAGC	Seq Percent=150%

CGNGCTNNGNNNNNNNNNNNNNCCCCTTGTCTCATCTGCTTGACGGTGAAGTCGTTGATGAGNNNNTNGNNNNGCTCGTTGAGGCCGCAGTGCAGGGTCACGCAGTCGCTGTGGAAGAGCAGGTCCTGCAGGGTGCTGACACGCTGCNGCN	Seq Percent=151%

TCCATTCTCTGNNNNNNNNNNNGAGTAAACCTGAATCTTTGGAGTACGCTGGATAGCCTCCAGNNNT	Seq Percent=67%

CGGGCTGTGTTCACCAGGAAGGCCCNTTGTCNNATCTGCTTGACGGTGANNTCGTTGATGAGGTGGTGNTTGTGCTCGNNNAGGCCGNAGTGCAGGGTNANGCAGTNGCTGTGGNAGAGCANNTCCTGCAGNNTGCTGANNCGCTGCAGN	Seq Percent=150%

TANATTNNCNNNNNNNNNNNNNGAGTAAACCTGAATCTTTGGAGTACGCTGGATAGCCTACANNNNANANNNNAAGAGAAGCGCGAGAACAGCTAAGGCCACGGAGCGAGACATCTCGGCCCGC	Seq Percent=124%

TCNATTCTCNNNNNNNNNNNNNGAGTAAACCTGAATCTAGGGAGTACGATGGATAGCCTCCANNNNANANNNNGAGAGTAGCGCGAGCACAGCTAAGGCCACGGAGCGAGACATCTCGGCCCGAATGCTGTCAGCTTCAGGAATGCCCCAN	Seq Percent=151%

TCCATTCTATGNTGNANNNNNTGAGTAAACCTGAATCTTTAGAGTACGCTGGATAGCCTCCAGGNNAGAAAGNGAGAGTAGCGCGAGCACAGCTAAGGCCACGGAGCGAGACATCTCGGCCCGAATGCTGTCAGCTTCAGGAATGCCCCAG	Seq Percent=151%

TCCATTCTCTGCTGGATGACGTGAGTAAACCTGAATCTTTGGAGTACGCTGGATAGCCTCCAGGCNAGAAAGAGAGAGTAGCGCGAGCACAGCTAAGGCCACGGAGCGAGACATCTCGGCCCGAATGCTGTCAGCTTCAGGAATGCCC	Seq Percent=148%

CAGGAATTCAATCTTCTCCTGGTCTGTGGAANCCTTATTCACTTCGGACTTCAAAGATCTCGTTTGAATATTTGCAACCCA	Seq Percent=81%

TCAATTCTCTGNTGNANNNNNTGAGTAAACCTGAATCTTTGGAGTACGCTGGATAGCCTCCAGGNNAGAAAGAGAGAGTAGCGCGAGCACAGCTAAGGCTACGGAGCGAGACATCATGGCCCGGC	Seq Percent=125%

CGGGCTGTGTTNACNANNNNNGCCCCTTGTCTCATCTGCTTGACGGTGAAGTCGTTGATGAGGNNNTGGTTNNGCTC	Seq Percent=77%

TCCATTCTCTGNTGNANNNNNTGAGTAAACCTGAATCTTTGGAGTACGCTGGGTAGCCTCCAGGNNTAAAG	Seq Percent=71%

TGGTTCACACCCATGACGAACATGGGGGCGTCAGCATATGGGGC	Seq Percent=44%

CGGGCTGTGTTCACCAGGAAGGCCCCTTGTCTCATCTGCTTGACGGTGAAGTCGTTGATGAGGTGGTGGTGGTGCTCGTTGAGGCCGCAGTGCAGGGTCACGCAGTCGCTGTGGAAGAGCAGGTCCTGCAGGGTGCTGACACGCTGCAGC	Seq Percent=150%

CGGGCTGTGTTCACCANGAAGGCCCCTTGTCTCATCTGCTTGACTGTGAAGTCGTTGATGAGGTGGTGGTTGTGCTCGTTGAGGCCGCAGTGCAGGGTCACGCAGTCGCTGTGGAAGAGCAGGTCCTGCAGGGTGCTGACACACTGCAGC	Seq Percent=150%

TGGTTCACACCCATGACGAACATGGGGGCATCAGCAGAGGGGGCAGAGATGATGACCCTTTTGGCTCCCCCCTGCAAATA	Seq Percent=80%

ATAGAAAAAAATAANCNNNNNAAGAAGGGAACAATAAAAAAAGAGCGAAAAAGAGAAAAAATAAANTAATGACAAATAAGAACAACAACTGAAAGGCAAAGGATGAAAGAGCTAGAAAATAAGGACGAACAGCGTAAAGAAAAGAACGCTA	Seq Percent=151%

TCCATTCTCNGNNNNNNNNNNNGAGTAAACCTGAATCTTTGGAGTACGCTGGATAGCCTCCAGNNNAAANNNNGAGAGTAGCGCGAGCACAGCTAAGGCCACGGAGCGAGACATCTCGGCCCGAATGCCGTCAGCTTCAGGAATGCCCAGN	Seq Percent=151%

TCCATTCTCTGNTGNANNNNNTGAGTAAACCTGAATCTTTGGAGTACGCTGGATAGCCTCCAGGNNAGAAAGNGAGAGTAGCGCGAGCACAGCTAAGGCCACGGAGCGAGACATCTCGGCCCGAATGCTGTCAACTTCAGGAATGCCC	Seq Percent=148%

TCNATNNNNNNNNNNNNNNNNNNAGTAAACCTGAATCTTTNGAGTACGCTGGATAGCCTCCANNNNNNNNNNNGAGAGTAGCGCGAGCACAGCTAAGGCCACGTA	Seq Percent=105%

TNGNGCTGGGAGANNAGGTGGAGANNNTCCTGNTGATCCCTNNANAGGANNCACAGCAGGCNGTCACNNATGTGGGAGCCCCGCCACACGCCCCCACCACCTCCTAGGCAGATNNTGCCCNNCTAGGGAGGNNNAACCGGAGGCCTGAGNN	Seq Percent=151%

CGGGCAGTGATCACCAGANNNGACAATTGTATCATATGCTTGACGGTGAAAACGTTGATGAGATNNGTGTTGNGCTCGTTGAGGCCGAAGTGAAGGATCACGCAGACGCTGTGGAAGAGCAGATCCTGCAGGGTGCTGACACGCTGCAGC	Seq Percent=150%

CATTCACTGCTGGATGACNNNAGTAAACCTGAATCTTTGGAGTACGCTGGATAGCCTCCAGGCAGNA	Seq Percent=67%

TCCATTCTCTGCTGGANGANNTGAGTAAACCTGAATCTTTGGAGTAGCT	Seq Percent=49%

TGGTTAACACCCNNNNCGAACATGGGGGCATCAGCAGAGGGGGCAGAGATGATGACCCTTTTGGCTCCCCCCTGCAAATGAGCCCCAGCCTTCTCCATGGTGGTGAAGACGCCAGTGGACTCCACGACGTACTCAGCGCCAGCATCGCCCN	Seq Percent=151%

TNCNTTCTCTGCTNNGATGACGTGNNNAAACNNGAATCTTTNNNNTACGNNGGATAGCCTNNNGGCCNNAAAGAGAGNNNANCGCGAGCACAGCTAAGGCCACGGAGCGAGACNNCTCGGNNNGAATGCTGNNNGCTTCTGGAATGCAANN	Seq Percent=151%

TCCATTCTCTGCTNNATGACGTGAGTAAACCAGAATCTTTGGAGTACGCTGGATAGCCTCCAGTCCAGNA	Seq Percent=70%

TCCATTCTCTGNNNNNNNNNNNGAGTAAACATGAATATTTGGAGTACGCTGGATAGCCTCAAGNNNAGAANNNGAGAGTAGAGCGAGAACAGCTAAGGACAAGATCGGAAGAGAGACGTGTAGGGAAACAGAGACAAAAGGAGAAGATCTN	Seq Percent=151%

TCCATTCTCTGCTGGATGACGTGAGTAAACCTTAATCTTTGGAGTAC	Seq Percent=47%

TCCATTCTCTGCTNNATGACGTGAGTAAACCTTAATCTTTGNNGTACGCTGGATAGCGTCCAGGCCANNAAGAGAGTTTAGCGCGAGCACAGATAAGGCCACGGAGCGAGACATCTCGGCCCTAATGCTGTCAGCTTCAGGTATGCCCCNN	Seq Percent=151%

TCCATTCTCTGCTNNATGACGTGAGTAAACCTTAATCTTTGGAGTACGCTGGATAGCGTCCAGGCCAGNAAGAGAGTTTAGCGCGAGCACAGATAAGGCCACGGAGCGAGACATCTCGGCCCTAATGCTGTCAGCTTCAGGTATGCCCCNN	Seq Percent=151%

TCCATTCTCTGCTGGATGACGTGAGTAAACCTGAATCTTTGGAGTACGCTGGATAGCCTCCAGGCNAGAA	Seq Percent=70%

TCCATTCTCNGNNNNNNNNNNNGAGTAAACCTGAATCTTTGGAGTACGCTGGACAGCCTCCAGNNNANANNNNGAGAGTAGCGCGAGCACAGATAAGGCCACGGACCGAGACATCTCGGCCCGAATGCTGTCAGCTTCAGTAATGCAGATN	Seq Percent=151%

TGGTTCACACCCANGACGAACATGGGGGCATCAGCAGAGGGGTCAGAGATGATGACCCTTTTG	Seq Percent=63%

TGGTTCACACCCATGACGAACATGGGGGCGTCAGCAGAGGGGGCAG	Seq Percent=46%

TCCATTCTCTGCTGGANGACGTGAGTAAACCTGAATCTTTGGAGTACGCTGGATAGCCTCCAGGCCAGAA	Seq Percent=70%

TCCATTCTCTGCTGNANGNNNTGAGTAAACCTGAATCTTTGGAGTACGCTGGATAGCCTCCAGANNATAAAN	Seq Percent=72%

TCCATTCTCTGCTGNANGNNNTGAGTAAACCTGAATCTTTGGAGTACGCTGGATAGCCTCCAGANNATAAAG	Seq Percent=72%

AAAAAAAAANANNNNNNNNNNNAAAAAAAAAAACAAAAAAAACAAAAAAAAAAAACAAAAAAANNNACANNNNAACAAAAACACACAAAAACAAAAAAAAAAAAACAAAAAAAAAACAAAAAAAAAAAAAAAAAAACAACAACAAACAAAN	Seq Percent=151%

TCCATTCTCTGCTGGATGACGTGAGTAAACCTGAATCTTTGGAGTACGCTGGATAGCCTCCAGGCCAGAAAGAGAGAGTAGCGCGAGCACAGCTAAGGCCACGGAGCGAGACATCTCGGCCCGAATGCTGTCAGCTTCAGGAATC	Seq Percent=145%

TCCAATCTCAGCAGNANNNNNAGAGTAAACCTGAATATTTGGAGAAAGCTGGAAAGACAACAGAANAGAAAGAGAGAGTAGCGCGAGCACAG	Seq Percent=92%

TCCATTCTCNGNNNNNNNNNNNGAGTAAACCTGAATCTTTGGAGTACGCTGGAAAGCCTCCAANNNTAANNNNCGGAAGAGCGACGTGTAGGGAAAGAGTGAACATCAGTGTAGATCACGATGGTAGCAGTATCATTAAAAAAAAAAAAAN	Seq Percent=151%

CATCGCACAGAACAGAGAGCATCGTGTAGGGAAAGAATGTACATCGATGTAGAACTCAGAGGACGCCGAAACAATAAAAAAAAAAAAAAAAGAAAAAGAAAAAAAAAAAGAGAAAAAAAAAAAAAAAAAAAAAAGGAAATAAGAAAAAAAA	Seq Percent=151%

GNGNCTATGATCANCAGAAAGGCCNNNTGTCNNATCTGCTANNCNGGGANNTCGTTGATANNAAGGTNNTAGTGCTCGNNNNGGCCNAAGTGCAAGGTCACGCAGNCGCAGTGNNNAAGANNNACCTGCAGNNNGCAGANNAGCAGCAGNN	Seq Percent=151%

TCNATNNNNNNNNNNNNNNNNNNAGTAAACCTGAAGCTTTNGAGTACGCTGGATAGCCTACANNNNNNNNNNNAAGAGTAACGCGAGCACAGCTAAGGCCACGGAGCGAGACATCTCGGCCCGAATGCTGTCAGCTTCAGAAATGCNNANN	Seq Percent=151%

TCCATTCTATGCTGGATGANNGGAGTAAACATGAATATTTAGAGTACGCTGGATAGCCTCCAGGCNAGAA	Seq Percent=70%

CGGGATGTGATNNNNNNNNNNNACCCTTGAATCATCTGCTTGACGGTGAAGTCGTTGATGAGGNNNGGGTNNNGCTCGCTGAGGCCGCAGTGCAGGGTCACGCAGTTGCTGTGGAAGAGCAGGTCCTGCAGGGTGCTGACACGCTGCAGCN	Seq Percent=151%

GGCTGCATGAAGTTTTAACATGGTAAAACTCATTGTATTTCCACGCTGGAAAATGATAGAGTGTTGGAATCACCACAGCAATGAGTGTCTGGGCAGACCACCAACTTGGAGAGGTGCAACAGGATATCCCAGTAAATCACAAGGGTGTAAG	Seq Percent=151%

TCCATTCTATANTGNATGACGTGAGTAAACCTGAATCTATGAAATACGCTGGATAGCCTCCAGGCCAGAAAGAGAGAGTAGCAAGAGCACAGCTAAGGCAACGGAGAGAGACATCTCGGCCCGAATGCTGTCAGCATCAGGAATGCCCCAG	Seq Percent=151%

TCCATTCTAAGCTGNATNNNNTGAGTAAACCTGAATCTTTGGAGAAGGCTGGAAAGCCTCCAGGNNAGAAAGNGAAAGTAGCGAGAGCACAGCTAAGGT	Seq Percent=99%

CGGGCTGTGTTCANNAGGAAGGCCCCTTGTCTCATCTGCTTGACGGTGAAGTCGTTGATGGGGTGGTGNGTGTG	Seq Percent=74%

TCCATTATCTGCTGGANNNNNGAGTAAACCTGAATCTTTGTAGTACG	Seq Percent=47%

GGGCAGATTGGNAANTNNNNNGAGCGTCGTGTAGGAAAAAATGGACAACGGTGGAAAAATTGGTNNGAGGCGNAAAAATAAAAAAAAAAAAAGAAAAAAAAAAAAAAAAAGAAAAAAAAAAAAAAGAAAAAACAAAAAGAAAAAAAAAGAA	Seq Percent=151%

TGNTTCNNACCCATGACGAACATGGGGGCGTCAGCAGAGGGGGCAGAN	Seq Percent=48%

TGGTTCACAACNATNANNNNNAAGGGGGCATCAGCAGAGGGAGCAGAGAAGAAGACCCTTTTAGCNCACCCATGCAAATGAGCCCCAGCCTTCTCCATGGAGGTGAAGACGCCAGTGGAATCCACGAAGTAATCAGCGCCAGCATCGCCCA	Seq Percent=151%

TCCATTCTCTGNTGNANNNNNTGAGTAAACCTGAATCTTTGGAGTACGCTGGATAGCCTCCAGGNNAGAAAG	Seq Percent=72%

TCCATTCTCTGCTGGATGACGTGAGTAAACCTGAATCTTTGGAGTACGCTGGATAGCCTCCAGGCCAGAAAGTG	Seq Percent=74%

CGGGCTGTGTTAACCANGANNAACCCTTGTCTAATCTTCTTAACGGGAAAGACGTTGATAAGGGGGTGGTTGTGCTCGTTAAGGCCGCAATGAAAGGTCAAGCAGTCGCTGTAGAAGAGCAGGTCCTGCAGAGTGCTGACACGATGGAGC	Seq Percent=150%

AGGGCGGNGTTAACAAGAAAGGCCAATTGTCTCATATGCTAAAAGGTAAAGACGTTGATGAGGAGNTGGTTGTACTCGTTGAGGACGCAGTGCAGGGTCACGCAGTCACTGTGGAGGAGCAGGTCCTGCAGGGAGCTGACACGCTGCAGC	Seq Percent=150%

TCNATTCTCTGNNNNNNNNNNNGAGTAAACCTGAATCTTTGGAGTACGCTGGATAGCCTCCAGNNNAGG	Seq Percent=69%

TCCATTCTCTGCTGGANGANNTGAGTAAACCTAAATCTTTGGAGTACGCTGGATAGCCTCCAGGCCAGAAAGAGAGAGTAGCGCGAACACAGCTAAGGCCACGGAGCGAGACATCTCGGCCCGAATGCTGTCAGCTCAAGGAATC	Seq Percent=145%

TCCATTCTCTGCTNGATGACGTGAGTAAAACTGAATATTTGGAGTACGCTGGATAGCCTCCAGGCCAGTTC	Seq Percent=71%

TNGNTCACACCNANNANNNNNATGGNGGCGTNNGCGGAGGGGGCAGAGANNATGACCCTTNNGGNNCCNCCCTGCAAANNNGCCCCNGCCTTCTCCATGGGGGTGAAGACGCCNNGGGACTNCACGACGTANNNAGCGCCNGCATCGCCNN	Seq Percent=151%

TNATTCACACCCANNACGAACATGGGGGCGTCAGCAGAGGGNNCAGAGATGATGACCCTTTTGGCTCNNCCCTGCAAATGAGCCCCAGCCTTCTCCATGGTGGTGAAGACGCCAGTGGACTCCACGACGTACTCAGCGCCAGCATCGCCCN	Seq Percent=151%

TAGTACTGGNNNNNNNAGGCGTNNTGTAGGGAAAGAGTGANNNNCGGTGTAGATCTCGGAGGNCGCNNNNNCATTAAAAAAAAAAAAAAAAAAATAAACAAAAAAACAACAAAAAGAATAAAAAAAAAAAAAAAAAGAATACAACGANAAN	Seq Percent=151%

GGNTCNNNANNNNNNNNNNNNNTATTACAGACATAAGCAGNACCTTGGGAGCTTGTTTGGAGNNNNTNGNNNNGGAGCGCAGCTACTCGTATACCCTTGACCGAAGACCGGTCCTCCTCTATCGGGGATGGTCGTCCTCTTCGACCGAGCG	Seq Percent=151%

TCCATTCTCTGCTNNNTGACGTGAGTAAACCTGAATCTTTGGAGTACGCTGGATAGCCTCCAGGCCAGAAAGAGAGAGTAGCGCGAGCACAGCTAAGGCCACGGAGCGAGACATCTCGGCCCGAATGCCAC	Seq Percent=131%

TCCATTCTCTGCTNNATGACGTGAGTAAACCTGAATCTTTGGAGTACGCTGGATAGCCTCCAGGCCAGAAAGAGAGAGTAGCGCGAGCACAGCTAAGGCCACGGAGCGAGACATCTCGGCCCGAATGCCAC	Seq Percent=131%

TGGTTCACNNNNNNNNNNAACANGGGGGCGTCAGCAGAGGNGGNAGAGATGATGACCCTTTTNNCTNNNNNNTGCAAATGAGCCCCAGCCTTCTCCATGGTGGTGAAGACGCCAGTGGACTCCACGACGTACTCAGCGCCAGCATCGCCCN	Seq Percent=151%

TGNTTCANANNNNNNNNNNNNNTGGGGGCGTCAGCAGAGGNCTCGGAGATCGGAAGAGCGACNNNNANNNNNNGAGTGTACATCGGTGTAGATATCGAAGGAAGCCATAACATTAAAAAAAAAAAAAAAAAAACAAAAAAAAAAAAAAAAN	Seq Percent=151%

TNCNTTCTCTGCTNNATGACGTGAGNAAACCNNAATCTTTGGAGTACGCNNGATAGCCTCNNGGCCGANAGGAGATCGNNNGAGCGNCGTGTAGGGAAAGAGTGTNCATCGGGNNAGATCTNGGTGGTCGCNNNATCATNNAAAAAAAANN	Seq Percent=151%

TANATTCTCNNNNNNNNNNNNNGAGTAAACCTGAATCTTTGGAGTACGCTGGATAGCCTCCAGNNCTGANNN	Seq Percent=72%

TGNTTCACACCNNNNNNNNNNNTGGGGGCGTCAGCAGAGGGGGCAGAGATGATGACCCTTTTGNNNCCCCNNNGCAAATGAGCCCCAGCCTTCTCCATGGTGGTGAAGACGCCAGTGGACTCCACGACGAACTCAGCGCCAGCATCGCCC	Seq Percent=150%

TGNTTCACANCNNNNNNNNNNNTGGGGGCGTCAGCAGAGGGGGCAGAGATGATGACCCTTTTGNNNCCCCNNNGCAAATGAGCCCCAGCCTTCTCCATGGTGGTGAAGACGCCAGTGGACTCCACGACGTACTCAGCGCCAGCATCGCCC	Seq Percent=150%

TGNTTCACANNNNNNNNNNNNNTGGGGGCGTCAGCAGAGGGGGCAGAGATGATGACCCTTTTGNNNCCCNNNNGCAAATGAGCCCCAGCCTTCTCCATGGTGGTGAAGACGCCAGTGGACTCCACGACGTACTCAGCGCCAGCATCGCCC	Seq Percent=150%

TGGTTCACACCCATGACGAACATGGGGGCGTCAGCAGAGGGGGCAGAGATAATGACCCTTTTGGCTCCCCCCTGCAAATGAGCCCCAGCCTTCTCCATGGTGGTGAAGACGCCAGTGGACTCCACGACGTACTCAGCGCCAGCATCGCCN	Seq Percent=150%

TGGTTCACACCCANGACGAACATGGNGGCGTNAGCAGAGGGGGCAGAGATNATGACCCTTTTGGCTCCNCCCTGCAAANGNGCCCCAGCCTTCTCCATGGTGGTGAAGACGCCAGTGGACTNCACGACGTACTCAGCGCCAGCATCGCCN	Seq Percent=150%

TCNATNNNNNNNNNNNNNNNNNGAGTAAACCTGAATCTTTGGAGTACGCTGGATAGCCGTCTNNNNGNNNNNNTCTCCTGAATCGAACCCTGATTCCCCGTCACCCGTGGTCACCATGGTAGGCACGGCGACTACCATCGAAAGTTGATAN	Seq Percent=151%

TCCATTCTCTGCTGGATGACGTGAGTAAACCTGAATCTTTGGAGTACGCTGGATAGCCTCCAGGCCAGAAAGAGAGAGTAGCGCGAGCACAGCTAAGGCCACGGAGCGAGACATCTCGGCCCGAATGCTGTCAGCTTCAGCAATGCCC	Seq Percent=148%

CGNGCTGTGNNNNNNNNNNNNNCCCCTTGTCTTATTTGCTAGATCGGAAGAGCGTCGTGTAGGNNNAGANNNNACATCGGTGTAGATCTCGGTGGTCGCCGTATCATTAAAAAAAAAACAAAAACAAAAAAAAAAAAAAACGACAACAAAA	Seq Percent=151%

TCCATTCTCTGCTNNNTGACGTGAGTAAACCTGAATCTTTGGAGTACGCTGGATAGCCTCCANGGCANNA	Seq Percent=70%

TNGNTCACACCCANNACGGCTAGTGCGGTCCAGTAATTTTTTTGTTCATGCTTCCAGTAAAATTTCATNAGAAGAAAGGGCAGGGTGGGGTGGAGTTCAAAATTTCTAGCCTGATTTCCTCATTTAACAGATGTTACAGCTAAGGTACANN	Seq Percent=151%

AATCTTCCAACTTAAANTCTGGATCTGTAAATTATTTGAAGTGCTCTTTCTTATCTCAAGGATATAGTATGTAATTCTACATCCATTATCTTCAGCTTTCTACCACTGTACTGAAGATCGGAAGAGAGACGTGTATGGAAAGAGTGAACAT	Seq Percent=151%

TGNTGCNNAGANNNNNNNNNNNCGTGTAGGGAAAGAGTGTACATCGGTGTAGATCTCGGTGGTCNNCGTATCNTTAAAAAAAAAAAAAAAAAAGAAATAAAAAGCAAAGTGGAACAAAAAATAAAAAGATAATAGACGAAGAGAAAAGACA	Seq Percent=151%

TCCATTCTCTGCTGNANNNNNTGAGTAAACCTGAATCTTTGGAGTACGCTGGATAGCCTCCAGGCCAGCT	Seq Percent=70%

CGGGCTGTGTTCANCAGGAAGGCCCCTTGTCTCATCTGCTTGACGGTGAGGTCGTTGATGAGGTGGTGNTTGTGCTCGTTGAGGCCGCAGTGCAGGGTCACGCAGTCGCTGTGGAAGAGCAGGTCCTGCAGGGTGCTGACACGCTGCAGC	Seq Percent=150%

TNCNTTCTCNNCNNNNTGACGTGNGTAAACNTGAATCTTTNNNNNACGCTGNATAGCCTCCANGCCANNNAGAGAGAGTAGCGCGAGCACAGCTAAGGCCACGGAGCGAGACATCTCGGCCCGAATGCNGTCAGCTTCAGTAATGNNNANN	Seq Percent=151%

TCCNTTCTCTGCTNGATGACGTGAGNAAACCNGAATCTTTGGAGTACGCNNGATAGCCTCCAGGCCAGNA	Seq Percent=70%

TCNATTCTCNGNNNNNNNNNNNGAGTAAACCTGAATCTTTGGAGTACGCTGGATAGCCTCCAGNNNAGAANNNGAGAGTAGCGCGAGCACAGCTAAGGCCACGGAGCGAGACATCTCGGCCCGAATGCTGTCAGCTTCAGAAATGCCC	Seq Percent=148%

TGNTTCACANANNNNNNNNNNNTGGGGGCATCAGCAGAGGGGGCAGAGATCGGAAGAGCGTCGNNNAGGGNNNGAGTGTACATCGGTGTAGATCTCGGTGGTCGCCGTATCATTAAAAAAAAAAAAAAAAAAAGTCAAAGAGTAAGCACTA	Seq Percent=151%

TGGTTCACACCCATGACGAACATGGGGGCGTCAGCAGAGGGGGCAGAGATGATGACCCTTTTGGCTCCCCCCTGCAAATGAGCCCCAGCCTTCTCCATGGTTGTGAAGACGCCAGTGGACTACACGACGTACTCAGCGCCAGCATCGCCC	Seq Percent=150%

TGGTTCACACCCATGACGAACATGGGGGCGTCAGCAGAGGGGGCAGAGATGATGACCCTTTTGGCTCCCCCCTGCAAATGAGCCCCAGCCTTCTCCATGTTGTTGAAGACGCCAGTGGACTCCACGACGTACTCAGCGCCAGCATCGCCC	Seq Percent=150%

TCCATTCTCTGCTGGANGACGTGAGTAAACCTGAATCTTTGG	Seq Percent=42%

CGGGCTGTGTTCACCANGAAGGCCCCTTGTCTCATCTGCTTGACGGTGAAGTCGTTGATGAGGTGGTGGTTGTGCTCGTTGAGGCCGCAGTGCAGGGTCG	Seq Percent=100%

AAAAACCAAATTGAGGNGTATGGGATGGGAGGAGAAAGAGTTGGAGGACTAAAAGCAAGGGAAGAAGAAAAAAAAGAGGAGAGGAAGAGAAGGGAGTAGAGAAAAAAAAGAAAGAGAGAGAAAGGATAGAGAGAGGTGGAGAAGAAAAAAA	Seq Percent=151%

TACATTCTCTGNTGNANNNNNTGAGTAAAACTGAATCTTTGGAGTACGCTGGAAAGACTCCAGGNNTAGAAANGATCGGAAGAGCGTAGTGAAAGGAAAGAGTGTACATCGGTGTAGATCAAAGAGATCGAAGTATAATAAAAAAAAAAAA	Seq Percent=151%

TGGTTAACACCGATGANGAACATGGGGGCATCAGCAGAGGGGGAAGAGAAAATGACACTTTTGGATCCCCCCTGCAAATGAGCCCCAGCCTTCTCCATGGTGGTGAAGACGCCAGTGGACTCAACGACGTACTCAGCGCCAGCATCGCCC	Seq Percent=150%

TANAAANNGTGNNNNNNNNNNNGAATGANACTGAATCTTTAGAATACNCAGAATAGACTCCAGNNNANNNNNAGAGAGTAGAGAGAGAACAACAAAGGACACGGAGAAAGACATCTCGGCACGAATGCTATCAGCTTCAGGAATGCACCAN	Seq Percent=151%

TCCATTCTCTGCTGGAAGACGTGAGTAAACCTGAATCTTTGGAGTACGCTGGATAGCCTCCAGGCAAGAAA	Seq Percent=71%

GCGATGAAGTTCTNGCTTCCTAGAGTAAAACTGAATCTTTGGAGAAAGCTGAATAGCCTCCAGCCTAGNACCAGAGAGTAGAGCGAGCACAGCTAAGGCCAAGGAGCAAGACATATCAGACCGAAAGCAGTCAACTACAGGAATGCAAANA	Seq Percent=151%

TCCATTCTCTGCTGGATGACGTGAGTAAACCTGAATCTTTGGAGTACGCTGGATAGCCCCCAGAATAGAA	Seq Percent=70%

TCCATTCTCTGCTGNATGACATGAGTAAACCTGAATATTTGAAGTAAGCAGGATAACCTCCAGGCCAGAAAGAGAGAGTAGCAAGAGCAAAGCTAAGGCCACGGAGCGAGACATCACGGCACGAAAGCTGACAGCTTCAGGAATACCCA	Seq Percent=149%

TCCATTCTCTGNNNNNNNNNNNGAGTAAACATGAATCTTTGGAGTACGCTGGATAGCCTACAGNNNAGAANNNTCAGAAGAGCGTCGTGTAGAGAAAGAGTGTACATCGGTGTAGAACTAGGAGGTCGACGAATAATAAAAAAAAAAAAAA	Seq Percent=151%

GGAGAAAAAAAAAAGGAAGAAAGGAGGGGAAGGGGAAAGAGGGAAGCCGGGGGAGAATCGGGGGGGGCGGGAGAAATAAAAAAAAAAAAAAAAAGAAAAAGAAAAGAAGAACAAAAAAAGAAAAAAAAGAAAAAAGAATAGAGACAAAAAA	Seq Percent=151%

TCCATTCTCTGNTGNANNNNNTGAGTAAACCTGAATCTTTGGAGTACGCTGGATAGCCTCCAGCNNAGAA	Seq Percent=70%

TCCATTCTCTGNNGNNNNNNNNGAGTAAACCTGAATCTCTGGAGCACAGATCGGAAGAGCGTCNNNTAGGNNNAGAGTGTACATCGGAGTAGATCTCGGTGGTCGCCGTATCATTAAAAAAAAAAAAAAAAAAAAAAAAAAAAATAAAAAA	Seq Percent=151%

TCCATTCTCTGCTGGATGACGTGAGTAAACGTGAATCTTTGGGGTACGCTGGATAGCCTCCAGGCCAGAAAGAGAGAGTAGCGCGAGCACAGCTAAGGCCACGGAGCGAGACATCTCGGCCCGAATGATGTCAGCTTCAGGAATGCCA	Seq Percent=148%

TCNATTNNCNNNNNNNNNNNNNNAGTAAACATGAATCTTTNGAGTACGCTGGATAGCCTCCANNNNANNNN	Seq Percent=71%

CGNGCNNNNNNNNNNNNNNNNNNNCCAGGTGTATATCGGANGANCGTCGTGTAGGGAAAGAGNNNNNNNNNNNGTAGATCTCGGTGGTCGCCGTATCATTAAAAAAAAAAACAAAACAACCAAAATGACAACAGATTAAAGAATGCANCAN	Seq Percent=151%

TCCATTCTCTGCTGGATGACGTGAGTAAACGTGAATCTTTGGAGTACGCTGGATAGCCTCCAGGCCAG	Seq Percent=68%

TACATTCTCTGNNNNNNNNNNNAAGNAAACANGAACATTTGGAGTACGCTNGATAGCCTCCAGNNNAANANNNAATCGNAAGAGCGTCGTGTAGGGAANAAGTGTANAACGGTGTAGATCTNGGAAGTCGCCGTAACAANAAAAAAAAANA	Seq Percent=151%

CGGGCTGTGTTNNNNNNGAAGGCCCCTTGTATCATCTGCTTGACGGTGAAGTCGTTGATGAGGNGGTGGTNNTGCTCGTTGAGGCCGCAGTGCAGGGTCACGCAGTCGCTGTGGAAGAGCAGGTCCTGCAGGGTGCTGACACGCTGCAGC	Seq Percent=150%

TCCATTCTCTGCTGGATGACGCGAGTAAACCTGAATCTTTGGAGTACGCTGGATAGCCTCCAGGCCAGAAAGAGAGAGTAGCGCGAGCACAGCTAAGGCCACGGAGCGAGACATCTCGGCCCGAATGCTGTCAGCTTCAGGAATGCCCCAG	Seq Percent=151%

TNCNTTCTCTGCTNNATGACGTGANNAAACCNNAATCTTTGGAGTACGCNNGATAGCCTCCNGGCCAGNAAGAGAGAGNNGCGCGAGCACAGCTAAGGCCACGGAGCGAGACANNTCGGCCNGAATGCTGTNNNCTCCAGGAATCAGATNN	Seq Percent=151%

CGGGCTGTGNNCNNNNAGAAGGCNCCTTGTATCATCTGCTNNNNGGTGAAGTCGTTGATGAGNTGGTNNNTGTGCTCGTTGAAGCCGCAGTGCAGGGTCACGCAATCGGT	Seq Percent=110%

TCNATTCNCNNNNNNNNNNNNNGAGTAAACCTGAATCTTTGGAGTACGCTGGATAGCCTCCANNNNANANNNNGAGAGTAGCGCGAGCACAGCTTAGG	Seq Percent=98%

TACATTCTCTGCTGGANGACGTGAGTAAACATGAATATTTGGAGTAAGCTGGATAGCCTCCATGCCAGA	Seq Percent=69%

CGGGCTGTGTTCACCANGAAGGCCCCTTGTCTCATCTGCTTGACGGTGAAGTCGTTGATGAGGTGGTGGTTGTGCTCGTTGAGGCCGCAGTGCAGGGTCACGCAGTCGCTGTGGAAGAGCAGGTCCTGCAGGGTGCTGACACGCTGCAGC	Seq Percent=150%

TGNTTCNNANCNNNNNNNNNNNTGGGGGCATCAGCAGAGGGGGCAGAGATGATGACCCTTTTGNNNCCCCNNNGCAAATGAGCCCCAGCCTTCTCCATGGTGGTGAAGACGCCA	Seq Percent=114%

TCCATTCTCTGNTGNANNNNNTGAGTAAACCTGAATCTTTGGAGTACGCTGGATAGCCTCCAGANNCCGGAANAGCGTCGTGTAGGGAAAGAGTGTACATCGGTGTAGATCTCGGTGGTCGCCGTATCATTAAAAAAAAAAAAAAGGAGAA	Seq Percent=151%

TCCATTCTCTGCTGGATGACGTGAGTAAACGTGAATTT	Seq Percent=38%

TCCATTCTCTGCTGGANGACGTGAGTAAACGTGAATCTTTGGAGTACGCTGGATAGCCTCCAGGCCAGAA	Seq Percent=70%

TCCATTCTCTGNTGNANNNNNTGAGTCAACC	Seq Percent=31%

TCNATNNNNNNNNNNNNNNNNNNNGTAAACCTGAATATTTNGANTACGCTGGATAGACTAAANNNNNNNNNNNCGGAAGAGAGTCGGGTAGGGAAAGAGTGTACATCGGGATAGATATCGGTAAAAAACGAAAACAAAAAAAAACAANGAN	Seq Percent=151%

ACCATTCTCTGCTGGANNNNNTGAGTAAACCTGAATATTTGGAGTACGCTGGATAGACTACAGGCNAGAA	Seq Percent=70%

TCCATTCTCTGNNNNNNNNNNNGAGTAAACGTGAATCTTTGGGGTACGCTGGATAGCCTCCAGNNNAGAA	Seq Percent=70%

TCCATTCTCTGCTGGATGACGTGAGTAAACCTGAATCTTTGGAGTACGGG	Seq Percent=50%

CGGGCTGTGTTCNNNNGGAAGGCNCCTTGTCTCATCTGCTTGANGGTGAAGTCGTTGATGAGNTGGTNNNTGTGCTCGTTGAGGCCGC	Seq Percent=88%

TGNTTNNNNNNNNNNNNNNNNNNGGGGGCATCAGCAGAGGNGGNAGAGATGATGACCCTTTTNNNNNNNNNNNGCAAATGAGCCCCAGCCTTCTCCATGGTGGTGAAGACGCCAGTGGACTCCACGACGTACTCAGCGCCAGCATCGNCCN	Seq Percent=151%

TGNTTNNNNNNNNNNNNNNNNNNNGGGGNATCAGCAGAGGNNNNAGANATGATGACCCTTTTNNNNNNNNNNNGCAAATGAGCCCCAGCCTTCTCCATGGTGGTGAAGACGCCAGTGGACTCCACGACGTACTCAGCGCCAGCATCNNCCN	Seq Percent=151%

TCAATTCTCTGCTGGATGACGTGAGTAAACCTGAATCTTTGGAGTACGCTGGATAGCCCCCAGGCAAGAAAGAGAGAGTAGCGCGAGCACAGCTAAGGCCACGGAGCGAGACATATCGGCCCGAATGCTGTCAGATTCAGGAATACCC	Seq Percent=148%

TCCATTCTCTGCTGGATGACGTGAGTAAACCTGAATCTTTGGAGTACGCTGGATAGCCTCCAAGANC	Seq Percent=67%

TCNATNNNNNNNNNNNNNNNNNNAGTAAACCTGAATCTTTNGANTACGCTGGAAAGCCTCCANNNNNNNNNNNAAGAGTAGCGCGTCGTGTAGGGAAAGAGTGTACAACGGTGTAGATCACGGTGGTAGCCGTATCATTAAAAAAAANAAN	Seq Percent=151%

GGTGGTAGATGGAAGANCGNNGTGTAGGGAAAGAGTGTACATCGGTGTAGATCTCGGTTGTCGCAGTATCATTAAAAAAAAAAAAAAAAAAAAAAAAAAAACAAAAAAAAAAAAAAAAAAAAAAAAAAAAAAAAAAAAAAAAAAAAACAAA	Seq Percent=151%

CGGGCTGTGTTCACCAGGAAGGCCCCTTGTCTCATCTGCTTGACGGTGAAGTCGTTGATGAGGTGGTGGTTGTGCTCGTTGAGGCCGCAGTGCAGGGTCACGCAGTCGCTGTGGAAGAGCAGGTCCTGCAGGGTGCTGACACGCTGCAGC	Seq Percent=150%

TGGTTCACACCCATGACGAACATGGGGGCGTCAGCAGAGGGGGCAGAGATGATGACCCTTTTGGCTCCCCCCTGCAAATGAGCCCCAGCCTTCTCCATGGTGGTGAAGACGCCAGTGGACCCCACGACGTACTCAGCGCCAGCATCGCCC	Seq Percent=150%

TCCATTCTCTGNTGNANNNNNNGAGTAAACCTGAATCTTTGGAGTGCGCTGGATAGCCTCCAGNNNAGAAANNGAGAGTAGCGCGAGCACAGCTAAGGCCACGGAGCGAGACATCTCGGCCCGAATGCTGTCAGCTTCAGGAATGCCC	Seq Percent=148%

TCAATTCTCTGCTGAATGACGTGAGTAAACCTGAATCTATGGAGTACGCTGGAAAGCCTCCAGGCCAGAA	Seq Percent=70%

GGCTGCATGAAGTTTTNANNNGATAAAACTCATTGTATTTCCACTCCATTTTTAGTTTTTCCCCAAATCTCTTTTCCTAGTGGTAAGTGTTCCAAAGGATCTGAATAATAATTTTTAACAGCTATCTGTATCATGTATGTTGAAAATGGAT	Seq Percent=151%

GGCTGCATGAAGTTTTNNNNNGGTAAAACTCATTGTATTTCCACTCCATTTTTAGTTTTTCCCCANATCTCTTTTCCTGGTGGTAAGTGTTCCAAAGGATCTGAATAATAATTTTTTACAGCTACCTGTATCATGTATGTTGAAAATGGTT	Seq Percent=151%

GGCTGCATGAANTTNTNNNNNGGTAAAACTCATTGTATTTCCACTCCATTTTTAGGTTTTCCCCNNATCTCTNTTCCTGGTGGTAAGTGTTCCAAAGGATCTGAATAATAATTTTTTACAGCTATCTGAATCATGTATGTTGAAAATGGTT	Seq Percent=151%

TCAATTAACTGNTTNANNACTAGAGTAAACCTGAATCTTTGGAGTACGCTGGATAGCCTCCAGGACAGAAAGAGAGAGTAGCGCGAGCACAGCTAAGGCCACGGAGCGAGACATCTCGGCCCGAATGCTGTCAGCTTCAGGAATGC	Seq Percent=146%

TCCATTCTCTGCTGGATGACGTGAGTAAACATGAATCTTTGGAGACGCC	Seq Percent=49%

TCCNTTCTCTGNNGNNNNNNNNGAGNAAACCNNAATCTTTGGAGTACACNNGATAGCCTCCAGNNNAGNANNNGAGAGNANCGCGAGNACAGCTAAGGNCACGGAGNGAGACATCTCGGCCNGAATGCTGTCAGCTTCTNGAGAGCCAGNT	Seq Percent=151%

CAGGAATTAAATCTNCTACTGGTCTGTGGAACCCTTATTCAAAGTCTTAACTGCTACTTTGATTTCTCCACTTCCAACTCCTAAGATGTCCACTTA	Seq Percent=96%

TCCATTCTCTNCNNNNTGACGTGNGTAAACCTGAATCTTTNNNNAAAGCTGGATAGCCTCCANGACGNNNA	Seq Percent=71%

CGGGCTGTGTTNAANANNNNNGCCACTTGTCTCATCTGCTTGACGGTGAAGTCGTTGATGAGGTGNTGGTTGTGCTCGTTGAGGCCGCAGTGCAGGGTCACGCAGTCGCTGTGGAAGAGCAGGTCCTGCAGGGTGCTGACACGCTGCAGC	Seq Percent=150%

TCAATTCTCTGNTGNGNNNNNTGAGTAAACCTGAATCTTTGGAGTACACTGGATAGCCTCCAGGCNAGAA	Seq Percent=70%

TCNATNNNNNNNNNNNNNNNNNNNGTAAACCAGAATCGGANNNNCGTCGTGTAGGGAAAGAGNNNNNNNNNNNGTAGATCTCGGTGGTCGCCGTATCATTAAAAAAAAAAAATAAGATAATAAAAAAAAAAAACTAAGAATAAAAANNAAN	Seq Percent=151%

GGGTTCACACCCATGACGAACATGGGGGCATCAGCAGAGGTGGCAGAGATGAAGAAAATTATGGCTCCCCCCTGAATGAGAGCAACAGCCTTCTCCATGGTGGTGAAGAAGCCAGTGGACTCGAGCAGTGAGTCAGCGCGAGCATCGCCC	Seq Percent=150%

GCCATTCTCTGNTGNANNNNNTGAGTAAACCTGAAGCTGGGGAGTACGCTGGAGAGCATCAAGGCNAGAA	Seq Percent=70%

CGNGCNNNGNNNNNNNNNNNNNAAAATTNTATCATCTGCTAGAAGGTNAAAACGTTGATGAGNNNNGNNNNNNGCTCGTTGAGGCCGTAGTGCAGGGTCACGCAGTCGCTGTGGAAGAGCAGGTCCTGCAGAGAGCTGACACGCTGAAGCN	Seq Percent=151%

TGNTGANNACCCATTAAGAACATGAGGGCAGCAGCAGANGGGGCAGANATGATGACACTTTTGGCNCCCCCCTGCAAATGAGCCCCAGCCTTCTCCATGGTGGTGAAGACGCCAGTGGAATCCAANACGTACTCAGCGCCAGCATAGNCN	Seq Percent=150%

AGAGTCNNAAACATAGCAAAAGTGAGGGGATGAGCAGAGAGGGAAGAGATGATAAAACTTTTGACNGCAGCCTACAGATGAGACACAGCCTTCTCCATGGTCGTGAAGACGCCAGTAGAATACACAAAATACTCAGAGCCAGCATCGCCAA	Seq Percent=151%

CGGGCGGTGTTCACCAGGAAGGCCCCTTGTCNCATCTGCTTGACGGTGAAGTCGTTGATGAGGTGGTGGTTGTGCTCGTTGAGGCCGCAGTGCAGGGTCACGCAGTCGCTGTGGAAGAGCAGGTCCTGCAGGGTGCTGACACGCTGCAGN	Seq Percent=150%

TCCATTCTCTGCTNNATGACGTGAGTAAACCTGAATCTTTGNNNTACGCTGGATAGCCTCCANGCCANNAAGAGAGAGTAGCGCGAGCACAGCTAAGGCCACGGAGCGAGACATCTCGGCCCGAATGCTGTCAGCTTCAGGAATGCGCCGN	Seq Percent=151%

TCCATTCTCTGCTGGATAACGTGAGTAAACCTGAATCTTTGGAGTACGCTGGATAACCTCCAGGCCAGAAAAAGAGAGTAGAACGGGGACAGCTAAGGAAACGGAGCGAGACAACTCAGACCGAATGCAGTCAGCTTAAGGAATCCAGAAA	Seq Percent=151%

TCCAATCTCTGNTGNANNNNNTGAGTAAACCTGAATCTTTGGAGTACGCTGGATAGCCTCCAGGCNAGAAAGAGAGAGTAGCGCGAGCACAGCTAAGGCCACGGAGCGAGACATCTCGGCCCGAATGCTGTCAGCTTCAGGAATGCCCCAG	Seq Percent=151%

TCNATTNNCNNNNNNNNNNNNNGAGTAAACCTGAATCTTTGGAGTACGCTGGATAACCTACANNNNANANNNNGAGAGTAGCGCGAGCACAGCTAAGGCCACGGAGCGGAAAAACGGAAGAGAGTCGTGTAGGGAAAAGTGTACATCNGTN	Seq Percent=151%

AGGTTCACACCCATGACGAACATGGGGGCATCAGAAGAGGTGGCAGAGATGAAGAAAATCTAGGCT	Seq Percent=66%

TCCATTCTCTGCTGGATGACGTGAGTAAACCTGAATCTTTGGAGTACACTGGATAGCCTCCAGGCCAGAAAGAGAGAGTAGCGCGAGCACAGCTAAGG	Seq Percent=98%

CGGGCTGTGTTCACCAGGAAGGCCCCTTGTCTCATCTGCTTGACGGTGAAGTCGTTGATGAGGTGNTGGTTGTGCTCGTTGAGGCGGGCGTGCAG	Seq Percent=95%

TCCATTCTCTGCTGNANNNNNTAAGTAAACCTGAATCTTTGGAGTACGCTGGATAGCCTCCAGGCNAGAAAGAGAGAGTAGCGCGAGCACAGCTAAGGCCACGGAGCGAGACATCTCGGCCCGAATGCTGTCAGCTGC	Seq Percent=138%

GANATNNNNNNNNNNNNNNNNNNAGTAAACCTGAATCTTTNNNNTACGCTGGATAGCCTCCANNNNNNNNNNNGAGAGTAGCGCGAACACAGATAAGGCCACGGAGCGAGACAGCTCGGCCCGAAAGCTGAAAGCAAGAACGGAAANNAGN	Seq Percent=151%

TAAATTCTCAGCGGGATGAGGAGAGTAAACATGAATCTTTGGAGTACGCTGGATAGCCTCTAGGCACGA	Seq Percent=69%

TCCATTCTCTGCTGGATGACGTGAGTAAACCTGAATCTTTGGAGTACGCTGGATAGCCTCCAGGCTAGA	Seq Percent=69%

TCCATTCTCTGCTNGATGACGTGAGTAAACCTGAATCTTTGGAGTACGCTGGACAGCCTCCAGGCCAGNAT	Seq Percent=71%

TGGTTCACACCCATGANGAACATGGGGGCGTCAGCAGAGGGGGCAG	Seq Percent=46%

TCCATTCTCTGCTGGANGACGTGAGTAAACCTGAATCTTTGGAGTACGCTGGATAGCCTCCAGGCCATAA	Seq Percent=70%

TAAATTCTCAGCAGAATGAAGAGAGTAAACATGAATCTTTGGAGTACGCTGGATAGCCTCCAGGCAAGAAAGAGAGATTAGCGCGAGCACAGCTAAGGCCACGGAGCGAGACAACTCGGCACGAATGCGTTCAGCTTCAGGAATGACAAAG	Seq Percent=151%

TCCATTCTCTGCTGGATGACGTGAGTAAACCTGAATCTTTGGAGTACGCTGGATAGCCTCCAGACCAGAAAG	Seq Percent=72%

TCCATTCTCTGNTGNANNNNNTGAGTAAACCTGAATCTTTGGAGTACGCTGGATAGCCTCCAGCCNAGAA	Seq Percent=70%

TCCATTCTCTGNTGNANNNNNTGAGTAAACCTGAATCTTTGGAGTACGCTGGATAGCCTCCAGGNNAGAAANNGAGAGTAGC	Seq Percent=82%

TGGTTCACACCCATNACGAACATGGGGGCGTCAGCAGAGGGGGCAGAGATGATGACCCTTTTGGCTCCCCCCTGCAAATGAGCCCCAGCCTTCTCCATGGTGGTGAAGACGCCAGTGGACTCCACGACGTACTCAGCGCCAGCATCGCCCA	Seq Percent=151%

TCCATTCTCTGCTGGATGACGTGAGTAAACCTGAATCTTTGGAGTACGCTGGATAGCCTCCAGGCCAGAAAG	Seq Percent=72%

TCCATTCTCTGCTGGANGACGTGAGTAAACCTGAATCTTTGGAGTACGCTGGATAGCCTCCAGGCCCGAC	Seq Percent=70%

GTTTCTGGCGTTTAATNGNNNTTAGTAGGGTGGGGTTATTTTCGTTAATGTTAGTAAGGGTGGGGNAGCGAGGTTGACCTGTTAGGGTGAGAAGAATTATTCGAGTGCTATAGGCGCTTGTCAGGGAGGTAGCGATGAGAGTAATAGATAG	Seq Percent=151%

TAAATTCTCAGCAGGATGAAGAGAGTAAACATGAATCTTTGGAGTACGCTGGATAGCCTCCAGGCAGTC	Seq Percent=69%

GANAGAGAGNNNNNNNNNNNNNAAGTGTACATCGGTGTAGNAGTCGGAGGTCGCCGTATAATNNNNANANNNNAAAGAAGAAAAAAAAGAAAAAAAGAAGAAAAAAAAAAAAAAAAAGAAGAGAAAAAAATAAAAAGAATAGAAGAANAAN	Seq Percent=151%

TACATTCTCTGCGGGATGAAGAGAGNAAACANGAATCTTTGGAGTACGCTGGATAGCCTCCAGGCAAGAAAGAGAGATNAGCGCGAGCACAGCTAAGGCCACGGAGCGAGACATCTCGGCANGAATGCGTTCAGCTTCAGGAATGACAANG	Seq Percent=151%

CGGGCTGTGTTNACNANNNNNGCCCCTTGTCTCATCTGCTTGACGGTGAAGTCGTTGATGAGGTGNTGGTTGTGCTCGTTGAGGCCGCAGTGCAGGGTCACGCAGTCGCTGTGGAAGAGCAGGTCCTGCAGGGTGCTGACACGCTGCAGC	Seq Percent=150%

TCCATTCTCTGCTGGATGACGTGAGTAAACCTGAATCTTTGGAGTACGCTGGATAGCCTCCAGGCCAGAAAC	Seq Percent=72%

TCCATTCTCTGCTGGATGACGTGAGTAAACCTGAATCTTTGGAGTACGCTGGATAGCCTCCAGGCCAGAAAGAGAGAGTAGCGCGAGCACAGCTAAGGCCACGGAGCGAGACATCTCGGCCCGAATGCTGATC	Seq Percent=133%

TCCATTCTCTGCTGGATGANNTGAGTAAACCTGAATCTTTGGAGTACGCTGGATAGCCTCCAGGCNAGAACT	Seq Percent=72%

TGGTTCACANNNNNNNNNNNNNTGGGGGCGTCAGCAGAGGGGGCAGAGATGATGACCCTTTTGNNNCCCNNNNGCAAATGAGCCCCAGCCTTCTCCATGGTGGTGAAGACGCCAGTGGACCCCACGACGTACTCAGCGCCAGCATCGCCCN	Seq Percent=151%

TCNATNNNCNNNNNNNNNNNNNGAGTAAACCTGAATCTTTGGAGTACGCTGGATAGCCTCCANNNNANNNNNNGAGAGTAGCGCGAGCACAGCTA	Seq Percent=95%

TGNTTNNNANNNNNNNNNNNNNNGGGGGCGTCAGCAGAGGNGGCAGAGATGATGACCCTTTTNNNNCNNNNNNGCAAATGAGCCCCAGCCTTCTCCATGGTGGTGAAGACGCCAGTGGACTCCACGACGTACTCAGCGCCAGCATCGNCCN	Seq Percent=151%

AGTAAGTATGAAANTTGTTTCTGGTATCCAAAAATCATCTCCAACTAATATAATATTCTCACTGATTCNACTATATTCACCAAACCCTAGATTATTTGCAGCTACTACTCTGAACTGAAATATTCCTTTCAGGTTTTTGGACTTCCATGNG	Seq Percent=151%

TCCATTCTCTGCTGAANAAAGTGAGTAAACCTGAATCTTTAGAGTACGCTGGATAGCCTCCAGGCCAGGA	Seq Percent=70%

TACATTCTCTGCTGNANNNNNTGAGTAAACCTGAATCTTTGGAGTACGCTGGATAGCCTACGGGCNA	Seq Percent=67%

TCCATTCTCTGNTGNANNNNNTGAGAAAACCTGAATCTTTGGAATACGCTGGAAAAACTCCAGGCNAGAAAGAGAGAGTAGCGCGAGCACAGATAAGGCCACGGAGCGAGACATCTCGGCCCGAATGCTGTCAGCTTCAGGAATGCCC	Seq Percent=148%

TCNATNNNCNNNNNNNNNNNNNNAGTAAACCTGAATCTTTNGAGTACGCTGGATAGCCTCCANNNNAGANNNNGAGAGTAGCGCGAGCACAGCTAAGGCCACGCT	Seq Percent=105%

TCCATTCTCTGNTGNANNNNNTGAGTAAACCTGAATCTTTGGAGTACGCTGGATAGCCTCCAGGNNAGAAANAGAGAGTAGCGCGAGCACAGCTAAGGCCACGGAGCGAGACATCTCGGCCCGAATGCTGTCAGCTTCAGTAATGCCCCAA	Seq Percent=151%

TGGTTCACACCCATGACTAACATGGGGGCATAAACAGAGGGGGTAGAGATGATGACCCTTATGGCTCAACCCTGCAAAAGAGCCCCAGCCTTCTCCAGGGTGGTGA	Seq Percent=106%

TCCATTCTCTGCTGNANNNNNTGAGTAAACCTGAATCTTTGGAGTACGCTGGATAGCCTCCAGGCNAGAAAGAGAGAGTAGCGCGAGCACAGCTAAGGCCACGGAGCGAGACATCTCGGCCCGAATGCTGTCAGCTCCAGGAATC	Seq Percent=145%

TGNTTNNNNNNNNNNNNNNNNNNNGGGGNGTAAGCAGAGGNNNNAGAGATGATGACCCTTATNNNNNNNNNNNGCAAATGAGCCCCAGCCTTCTCCATGGTGGTGAAGACGCCAGTGGACTCCACGACGTACTCAGCGCCAGCATCNNCAN	Seq Percent=151%

TCCATTATCTGCTGGATGACGTGAGTAAACCTGAATCTTTGGAGTACGCTGGATAGCCTCCAGGCCACAACA	Seq Percent=72%

GAAAAAGAAAACATAAATAAAAATATTGAAAAAAGAAAATAAGGAGTAAGAGGTAATTAGATGAAGGGTAGAATTTATAGATCTATATAATAGAATTATAAAAAAAAAGAAGATAGAAATAAACAAAAGAAGTATAAAAAACAAAAATTAA	Seq Percent=151%

AGATTAAGACCCCTGCNTANNATTGGGGCGTCAGCAGAGGTTTCAGAGATGATGACCCTTTTTTCTCCCCCAAGCAAATGAGCCCCAGCCTTCTCCATGGTGGTGAAGACGCCAGTGGACTCCACGACGTACTCAGAGCCAGCATCTCCC	Seq Percent=150%

TCCATTCTCTGCTGGATGACGTGAGTAAACCTGAATCTTTGGAGTACGCTGGATAGCCTCCAGGCCAGAAAGAGAGAGTAGCGCGAGCACAGCTAAGGCCACGGAGCGAGACATCTCGGCCCGAATGCTGTCAGCTTCAGGAATGCCCCAG	Seq Percent=151%

TCCATTCTCTGCTGGANTANNTGAGTAAACCTGAATCTTTGGAGTACGCTGGATAGCCTCCAGGCCAGAAAGAGAGAGTAGCGCGAGCACAGCTAAGGCCACGGAGCGAGACATCTCGGCCCGAATGCTGTCAGCTTCAGGAATGCCCCAG	Seq Percent=151%

ACAATAAACTTCTTGCTTACGTTCGTAAACCTGAATCTTTTTCTTACGCTGGATAGCCTCCATTCCATCCCGAGAGAGTAGCGCGAGCACAGCTAAGGCCACGGAGCGAGACATCTCGGCCCGAAAGCTGTCATCTACAGGAATGCCCC	Seq Percent=149%

TCCATTCTCTGCTGGATGACGTGAGTAAACCTGAATCTTTGGAGTACGCTGGATAGCCTCCAGGCCAGAAAGAGAGAGTAGCGCGAGCACAGCTAAGGCCACGGAGCGAGACATCTCGGCCCGAATGCTGTCAGCTCTAGGAATC	Seq Percent=145%

CGGGCTGTGTTCACCANNNNNGCCCCTTGTCTCATCTGCTTGACGGTGAAGTCGTTGATGAGGTGNTGGTTGTGCTCGTTGAGGACGCAGTGCAGGGTCACGCAGTCGCTGTGGAAGAGCAGGACCTGCAGGGTGCTGACACGCTGCAGC	Seq Percent=150%

CGGGATGTGTTCACAAGAAAAGCCCCTTGTCTCATCTGCTTGACGGTGAAGTCGTTGATGAGGTGGTAGTTATGCTCGTTGAGACCGCAGTNAAGATCGGAAANNAGTCGTGTAGGGAAAGAGAGAACAACAGTGTAGATCTCGGTGGTCG	Seq Percent=151%

TCNAANNNNNNNNNNNNNNNNNNNGTAAACCTGAATCTTTNNNNTACGCTGGATAGCCTCCANNNNNNNNNNNG	Seq Percent=74%

TCCATTCTCTGCTGGANTACNTGAGTAAACCTGAATCTTTGGAGTACGCTGGATAGCCTCCAGCCCAGAAG	Seq Percent=71%

TCCATAAACTTNNNNNNNNNNNTCGTAAACCTGAATCTTTTTCTTACGCTGGATAGCCTCCATNNNATCCNNNGAGAGTAGCGCGAGCACAGCTAAGGCCACGGAGCGAGACATCTCGGCCCGAAGGCTGTCATCTACAGGAAGGCCCC	Seq Percent=149%

TCAAATAAAAGCATGATTAAAAGAGTAAACCTGAATCTTTGGAGTACGCTGGATAGCCTCCAGGANAGAAAGAGAGAGTAGCGCGAGCACAGCTAAGGCCACGGAGCGAGACATCTCGGCCCGGATGCTGTCAGCTTCAGGAATCA	Seq Percent=146%

TCCATTATATGCTGGATGACGAGAGTAAACCTGAATCTTTGGAGTACGCTGGATAGCCTCCAGGCAAGAAAGAGAGAGTAGCGCGAGCACAGCTAAGGCCACGGAGCGAGACATCTCGGCCCGAATGCTGTCAGCTTCAGAAATGCCC	Seq Percent=148%

TCCATTCTCAGCTGGATGACGAGAGTAAACATGAATATTTGGAGTACGCTGGATAACCTCCAGGCCAGAAAGAGAGAGTAGCGCGAGCACAGCTAAGGCCACGGAGCGAGACATCTCGGCCCGAATGCAGTCAGCTTCAGAAATGCCC	Seq Percent=148%

TCCATTATCTGCTNNAAGACGTGAGTAAACATGAGTATGTGGAGTACACTGGATAGCCTCCAGGACAGAAAG	Seq Percent=72%

TGGTTCACAACCATGACGAACATGGGGGCATGAGCAGAGGGGGCAGAGATGATGACCCTTTTAGCTCCCCCCTGCAAATGAGCCCCAGCCTTCTCCATGATGGTGAAGACGACAGTGGACTCCACGACATACTCAGCGCCAGCATCGCCC	Seq Percent=150%

TCCATTCTATGNNGNNNNNNNTGAGTAAAACTGAATATTTGGAGTACGCTGGATAGCCTCCAANNNAGAAANN	Seq Percent=73%

GGCAGCAAGATNNNNNNNNNNNCGTGTAGGGAAAGAGTGTCCATCGGTGTAGATATCGGTGGCNNNGGTANNNTTAAAAAAAAAAAGAGAAAAAGAAAAAGAAAGAAGAAAAAGGAGAAAAGAAAAGAAGAAGAAAAAGAAAAAAAACGAA	Seq Percent=151%

TCCATTCTCTGCTGGATGACGTGAGTAAACCTGAATCTTTGGAGTACGCTGAATAGCCTCCAGGCCAGAAAGAT	Seq Percent=74%

TCCATTCTCTGCTGGATGACGTGAGTAAACCTGAATCTTTGGAGTACGCTGGATAGCCTCTACGCN	Seq Percent=66%

TGNTTNNNNNNNNNNNNNNNNNNGGGGGCATCAGCAGAGGNNGNAGAGATCGGAAGAGCGTCNNNNANNNNNNGAGTGTACATCGGTGTAGATCTCGGTGGTCGCCGTATCATTAAAAAAAAAAAAAAAAAAAAAAAGAAAAAAAAANAAN	Seq Percent=151%

TGGTTCACACCCATGANGAACATGGGGGCATCAGCAGAGGGGGCAGAGATGATGACCCTTTTGGCTCCCCCCTGCAAATGAGCCCCAGCCTTCTCCATGGTGGTGAAGACGCCAGTGGACTCCACGACGTACTCAGCGCCAGCATCGCCC	Seq Percent=150%

TGGTTCACACCNNNNNNNNNNNTGGGGGCATCAGCAGAGGGGGCAGAGATGATGACCCTTTTGNNNCCCCNNNGCAAATGAGCCCCAGCCTTCTCCATGGTGGTGAAGACGCCAGTGGACTCCACGACGTACTCAGCGCCAGCATCACAC	Seq Percent=150%

TCCATTCTCTGCTGNANNNNNTGAGTAAACCTGAATCTTTGGAGTACGCTGGATAGCCTCCAGGCNAGTT	Seq Percent=70%

TCNATNNNNNNNNNNNNNNNNNNAGTAAACCTGAATCTTTNGAGTACGCTGAATAGCCTCCANNNNANNNN	Seq Percent=71%

TGGTTCACACCNNTNNNNNNNNTGGGGGCATCAGCAGAGGCGGCAGAGATGATGACCCTTTTCNNNCCCCCNNGCAAATGAGCCCCAGCCTTCTCCATGGTGGTGAAGACGCCAGTGGACTCCACGACGTACTCAGCGCCAGCATCGCAC	Seq Percent=150%

TGGTTCACACCNNNNNNNNNNNTGGGGGCATCAGCAGAGGCGGCAGAGATGATGACCCTTTTCNNNCCCCNNNGCAAATGAGCCCCAGCCTTCTCCATGGTGGTGAAGACGCCAGTGGACTCCACGACGTACTCAGCGCCAGCATCGCAC	Seq Percent=150%

TCCATTCTCTGNNNNNNNNNNNGAGTAAACCTGAATCTTTGGAGTACGCTGGATAGCCTCCAGNNNAGAGN	Seq Percent=71%

TCNATTCTCNNNNNNNNNNNNNGAGTAAACTTGAATC	Seq Percent=37%

ATCACCGCGCGNNANNNNNNNTCGCACAGTGGATCCTGGATGTCTTCGGGCTCGCAGAAGCACTNNTCCTCNNCAGGGAAGCAGTTGCAGGTGCCATAGCCAGCTTTAATCCCCCGGGACC	Seq Percent=121%

AAAGAAGAACAGAAAGAAGAAAAGAACAAGGATGGCAAAACAGAAGAAGCAAGACAGAAAAAAAANCACAGTCAACAAAACAAAAAAAAAAAAAACAAAAAAAAATGCAAGTAAAAATAAAAAACAAAACAATAAAGATAATACACGA	Seq Percent=148%

ACAAACAAAAAGAAATAAAGACAGAAGGGACAACAAAAGAAAGCAGAAAACAGACATAATGAAAANCACGAATAAAAAACAAAAACACACAAAACCAAACAAAAAAAACAAAGAACAAACGAAATAATATAACACAAAAAAAAATAAAAAA	Seq Percent=151%

TCCATTCTCTGCTGGATGACGTGAGTAAACCTGAATCTTTGGAGTACGCTGGATAGCCTCAAGGTC	Seq Percent=66%

CGGGCTGTGTTCACCAGGAAGGCCCCTTGTCTCATCTGCTCGACGGTGAAGTCGTTGATGAGCTGGTGGTTGTGCTCGTTGAGGCCGCAGTGCAGGGTCACGCAGTCGCTGTGGAAGAGCAGGTCCTGCAGGGTGCTGACACGCTGCCGC	Seq Percent=150%

TCCATTCTCTGCTGGATGACGTGAGTAAACCTGAATCTTTGGAGTACTCTGGATAGCCTCCAGGCCAGAAAGAGAGAGTAGCGCGAGCACAGCTAGGACC	Seq Percent=100%

TCCATTCTCTGCTGGATGACGTGAGTAAACCTGAATCTTTGGAGTACGCTGGATAGCCTCCAGGCCAGAAAGAGAGAGTAGCGCGAGCACAGCTAGGACC	Seq Percent=100%

TCNATTCNCNNNNNNNNNNNNNGAGTAAACCTGAATCTTTGGAGTACGCTGGATAGCCTCCAGNNNCAGNN	Seq Percent=71%

NGNTGNNNGNNNNNNNNNNNNNNNAAANNTCATTGNNNNNNNNNGCNNGAAAATGGTAGAGTNNNNGNNNNNNNACAGCAATGAGTGTCTGGGCAGACCACCAACTTGGAGAGGTGCCACAGGAANTCCCAGTAAANNACAAGNGTNNCNN	Seq Percent=151%

TGGTTCACACANATGANNNNNATGGGGGCGTCAGCAGAGGGGGCAGAGATGATGACCCTTTTGGCNCCCCCCTGAAAATG	Seq Percent=80%

TCNATNNNNNNNNNNNNNNNNNNAGTAAACCTGAATCTTTNNANTACGCTGGATAGCCTAAANNNNANNNNNNGAGAGTAGAGCGAGCACAGCTAAGGCCACGGAGCGAGACATCTCGGCCCGAATTCTGTCAGCCTCAGGAATGCCNCAN	Seq Percent=151%

CGGGCTGTGTTCACNANNNNNGCCCCTTGTCTCATCTGCTTGACGGTGAAGTCGTTGATGAGGTGNCGGTTTTGCTCGTTGAGGCCGCAGTGCAGGGTCACGCAGTCGCTGTGGAAGAGCAGGTCCTGCAGGGTGCTGACACGCTGCAGC	Seq Percent=150%

CGGGCTGTGTTNNNNNNNNNNNCCCCTTGTCTCATCTGCTTGACTGTGAAGTCGTTGATGAGGNNNTGGTNNNGCTCGTTGAGGCCGCAGTGCAGGGTCACGC	Seq Percent=103%

CGGGCTGTGTTNACNANNNNNGCCCCTTGTCTCATCTGCTTGACGGTGAAGTCGTTGATGAGGTNNTGGTTNNGCTCGTTGAGGCCGCAGTGCAGGGTCACGCAGTCGCTGTGGAAGAGCAGGTCCTGCAGGGTGCTGACACGCTGCAGC	Seq Percent=150%

GATCATTAGNTNNNNNNNNNNNGTGTAGGGAAAGAGTGTACATCGGTGTAGATATCGGTGGTCNNNGTATNNNTAAAAAAAAAAATAAATCTGTCAACGCCGCTAATCAGGTAGGTTCTGTTGGTGCAGATATAGATTTAGATACCGACA	Seq Percent=150%

TCCATTCTCTGNTGNANNNNNTGAGTAAACCTGAATCTTTGGAGTACGCTGGATAGCCTCCATGNNCA	Seq Percent=68%

TCNATTNNCNNNNNNNNNNNNNGAGTAAACCTGAATCTTTGGAGTACGCTGGATAGCCTAAGNNNNANANNNNTCGAAGAGAGTCGAGTAGGGAAAGAGTGTACATCGGTGTAGATCTCGGTGGTCTCCGTATCATTAAAAAAAAAAACAN	Seq Percent=151%

TCCATTCTCTGCTGGANGACGTGAGTAAACCTGAATCTTTGGAGTACGCTGGATAGCCTCCAGGCCCTTCA	Seq Percent=71%

TCNATTCTCNNNNNNNNNNNNNGAGTAAACCTGAATCTTTGGAGTACGCTGGATAGCCTCCAGNNNAGANNNNGAGAGTAGCGCGAGCACAGCTAAGACA	Seq Percent=100%

TCNATTNNCNNNNNNNNNNNNNGAGGAAACCTGAATCTTTGAGGTACGCGGGATAGCCTCCAGNNNAGAN	Seq Percent=70%

TCCATTCTCTGNTGNANNNNNTGAGTAAACCTGAATCTTTGGAGTACGCTGGATAGCCTCCAGGCNAGAAAGAGAGAGTAGCGCGAGCACAGCTAAGGCCACGGAGCGAGACATCTCGGCCCGAATGCTGTCAGCTCCAGGAATC	Seq Percent=145%

TCCATTCTCTGCTGNANNNNNTGAGTAAACCTGAATCTTTGGAGTACGCTGGATAGCCTCCAGGNNAA	Seq Percent=68%

CTGGCAGTGTANACNANNNNNGACCCTAGTCTCATCTGCTAGAATGTGAAGTCGTTGATGAGGAGNTGGAAGAGATCGTTGAGGCCCCAGTGCA	Seq Percent=94%

TNCNTTCTCTGCTNGATGACGTGAGNAAACCNNAATCTTTGGAGTACGCNNGATAGCCTCTNGGCCAGNCC	Seq Percent=71%

TCNATTNNCNNNNNNNNNNNNNGAGTAAACCTGAATCTTTGGAGTACGCTGGATAGCCTCCAGNNNAGAN	Seq Percent=70%

TGGTTCACACCCATGACGAACATGGGGGCATCAGCAGAGGGGGCAGAGATGATGACCCTTTTGGCACCCCCCTGCAAATG	Seq Percent=80%

TCCATTCTCTGCTGGATGACGTGAGTAAACCTGAATCTTTGGAGTACGCTGGATAGCCTCCAGGCACGAAAG	Seq Percent=72%

AAGACTCNGAGNNNGNANANNGTCGTGTAGGGAAAGAGTGTACATCGGTGTAGATCTCGGTGGNCNCNGNATCATTAAAAAAAAAAAAAACAAAAACGAAACATAAAAAAACAAAAGAACAGAAACACAAGGATAGGAGAAGAAAAAAAAN	Seq Percent=151%

GATACATAGATNGGNANNNNNGTCGTGTAGGGAAAGAGTGTACATGGGTGTATGGGGGGGCGGTNNCCGTANNATTAAAACCAAGACAAGAAGTAGCGAAAGTACTGAAAAACAATGGACTAAAAAAAGAAAACTGGAACTAGAACAAGAA	Seq Percent=151%

CGGGCTGTGTTNNNNNNNNNNNCCCCTTGTCTCATCTGCTTGACGGTGAAGTCGTTGATGAGGNNNTGGTNNNGCTCGTTGAGGCCGCAGTGCAGGGTCACGCGGTCGCTGTGGAAGAGCAGGTCCTGCAGGGTGCTGACACGCTGCAGC	Seq Percent=150%

TCCCTTCTCTGCTTGCTGACGTTCGCTCGGCAGAGCGTAGTTTCTGTACCTCGTGTACATCGCTGTCCCCCTCGGTGGTCGCCGTATCATTAAAAAAAAAAAAAAAAAAAAAAAAAAAAGCCAAAAAATAAAAACAAAAAAAAACCTCTTA	Seq Percent=151%

TTGCCTTGAGANCTNCNNNNNGTCGTGGAGGGAAAGAGAGTCCCTGGGTTTCGATCTCGGTGCTCNCCTCATCATTAAAAAAAAAAAAAAAAAAAAAAAAACAAAAATAAAAAAAAAAAGCTAAAAAACAAAAATAAAATAAAACCTTTCA	Seq Percent=151%

TCCCTTCTCTGCNNNNTGACGTTNGTCAAGCTGAATCTATNNNNNACGCTTTATAGCCTCCANGCCCNNNCGAG	Seq Percent=74%

TCNATTCTCNNNNNNNNNNNNNGAGTAAACCTGAATCTTTGGAGTACGCTGGATAGCCTCCAGNNNAGANNNNG	Seq Percent=74%

TCCCTTCTCTGCTTGCNGACGTTCGTCAAGCTGAATCTATTTCTTACGCTTTATAGCCTCCACGCCCGCCAGAGAGAGTAGCGCGAGCACAGCTAAGGCCACGGAGCGAGACATCTCGGGCCGAAAGCTGTCAGCTAAGGGAATTCCCTCA	Seq Percent=151%

TCCATTCTCTGNTGNANNNNNTGAGTAAACCTGAATCTTTGGAGTACGCTGGATAGCCTCCAGGNNAGAAANNAAGAGTAGCGCGAGCACAGCTAACGCCACGGAGCGAGACATCTCGGCCCGAATGCTGTC	Seq Percent=132%

AAAAAAAAAACGAANGNANNNAAGCATCCAGATCAGAAAGACGTGCTAAAAAACCAAAAAACAACTAACACAAACAACAAACAAAAGCAAAAAAACTACAAACCAGATACGACAACTAATAACATAAACAAAGAAGAACAAGAAAAAG	Seq Percent=148%

TCCATTCTCTGNTGNATGACGTGAGTAAACCTGAATCTTTGGAGTACGCTGGATAGCCTCCAGGCCAGAAAA	Seq Percent=72%

GAAGCAGGAGAATANGNAGAAAAGANGCGAGNATGAAGAAAAGAAGATTAGACGTAAAAGGAAAAGAAGAAAAAAAGANGGAAAAAAAAAAATAAAAAAGAAAAAAACACATATAAAAATANACGAAAAAAGAAAAAAANAAAATGAAANG	Seq Percent=151%

TGGTTCACACCNNNNNNNNNNATGGGGGCGTCAGCAGAGGGGGCAGAGATGATGACCCTTTTGNNNCCCCCNNGCAAATGAGCCCCAGCCTTCTCCATGGTGGTGAAAACGCCAGTGGACTCCACGACGTACTCAGCGCCAGCATCGCCC	Seq Percent=150%

TCGGGCTGATTNCNNCNNNNNNGCCCCTTGTCTCATCTGCTTGACGGTGAAGTCGTTGATGAGNNNGTGTNNNTGCTCGTTGAGGCCGCAGAGCAGTGTC	Seq Percent=100%

TGGTTCACACCNNNNNNNAACATGGGGGCATCAGCAGAGGGGGCAGAGATGATGACCCTTTTGNCTCCCCNCTGCAAATTAGATCGGCAGCTCTTCGTGTATTTAAAGGTGTACATCGGAGTAGATATCGATGGACGCGGTATCATTAAAA	Seq Percent=151%

AANAANNNNNNNNNNNNNNNNNNGAGGGGAAGCGGGAGAGNNGNAGACAGAGGAGAGGATGGNNNNANNNNNNAGATAAAATGAAGAGTCGTAAATGGCAAACAAAAGAAAAAGAATAAAACAAGAAACAAGACAAAAGCAGAAAAANAGN	Seq Percent=151%

TCNATNNNNNNNNNNNNNNNNNGAGTAAACCTAAATCTTTGGAGAATGCTAGATCGGAAGAGCNNNGTGTNNNGAAAGAGTGTACATCGGGGTAGATCTCGGTGGTCGCCGTATCATTAAAAAAAAAAAAAAAAAGAAAGAGAAAAANGAN	Seq Percent=151%

TCCATTCNCNNNNNNNNNNNNTGAGTAAACCTGAATCTTTGGAGTACGCTGGATAGCCTCCANNNNANNNNNNGAGAGTAGCGCGAGCACAGCTAAGGCCACGGAGCGAGACATCACGGCCCGAATGCTGTCAGCTTCAGGAAAGCCCAGN	Seq Percent=151%

ACCATTCTCTGNNNNNNNNNNNGAGTAAACCTGAATCTTTGGAGTACGCTGGATAGCCTCCAGNNNGGAANNNG	Seq Percent=74%

11>>>133B3B###########0BAABDGAABBFFA1A2DDFGH1BAAB/BEG1DF1BB0/BB###B/BA###>	length=74

------------------

