ATACAGCGAAACCACAGCCAAGGGAACNNGGTTGGCGGAATCAGCGGGGAAAGAAGACCCTGTTGAGCTTGACTCTAGTCTGGCACGGTGAAGAGACGGCTGGAGTGTGAGGAAGGAAGAGCACACGTCTGAACTCCAGTTCACGTGTTTA	Seq Length=151

TAATAGACAGGAGGCTATACAGCGTACTCCAAAGATTCAGGTTTACTCACGTCATCCAGCAGAGAATGGA	Seq Length=70

TAATGGCCAGGAGGCTATACAGCGTACTCCAAAGATTCAGGTTTACTCACGTCATCCAGCAGAGAATGGA	Seq Length=70

AAAATCAAGTGGGGCGATGCTGGCGCTGAGTACGTCGTGGAGTCCACTGGAGTCTTCACCACCATGGAGAAGGCTGGGGCTCATTTGCAGGGGGGAGCCAAAAGGGTCATCAGCTCTGCCCCCTCTGCTGACGCACCCATGTTCGTCATGG	Seq Length=151

ATTCTGGCCTGGAGGCTATCCAGCGTACTCCAAAGATTCAGGTTTACTCACGTCATCCAGCAGAGAATGGA	Seq Length=71

NTATGGCCTGGAGGCTATCCAGCGTACTCCAAAGATTCAGGTTTACTCACGTCATCCAGCAGAGAATGGA	Seq Length=70

GGGGCCGAGATGTCTCGCTACGTGGCCTTAGCTGTGCTCGCGCTACTCTCTCTTTCTGGCCTGGAGGCTATCCAGCGTACTCCGAAGATTCAGGTTTACTCACGTCATCCAGCAGAGAATGGA	Seq Length=123

TCTGGCCCGGAGGCTATCCAGCGTACTCCAAAGATTCAGGTTTACTCACGTCATCCAGCAGAGAATGGA	Seq Length=69

GGGGCCTTCGCTGTGCTCGCGCTACTCTCTCTTTCTTGCCTGGAGGCTATCCAGCGTACTCCAAAGATTCAGGTTTACTCACTTCATCCAGCAGAGAATTGA	Seq Length=102

CTTTCTGGCCTGGAGGCTATCCAGCGTACTCCAAAGATTCAGGTTTACTCACGTCATCCAGCAGAGAATGGA	Seq Length=72

AAGGTTAACTCACGTCATCCAGCAGAGAATGGAAGATAGGAAGAGCAAACGTCTGAACTCCCTTCACGTGTTTATAAAGAAGTCCGGGGTGTGCATGACCAAAAAAAAGAAAAAATTTTANATCATTTACTTTATTCTTACTAACAATATA	Seq Length=151

AAGGTTAACTCACGTCATCCAGCAGAGAATGGA	Seq Length=33

AGGCATTCCTGAAGCTGACAGCATTCGGGCCGAGATGTCTCGCTCCGTGGCCTTAGCTGTGCTCGCGCTACTCTCTCTTTCTGGCCTGGAGGCTATCCAGCGTACTCCAAAGATTCAGGTTTACTCACGTCATCCAGCAGGGAATGGA	Seq Length=148

CTTTCAGGCCTGGAGGCTATCCAGCGNNNTCCAAAGATTCAGGTTTACTCACGTCATCCAGCAGAGAATGGA	Seq Length=72

GCCCCCTTGCTGACGCCCCCATGTTCGTCATGGGTGTGAACCA	Seq Length=43

TNCTTGCCTGGAGGCTATCCAGCGTACTCCAAAGATTCAGGTTTACTCACGTCATCCAGCAGAGAATGGA	Seq Length=70

GCGACCTGCGTGACCCTGCACTGCGGCCTCAACGAGCACAACCACCACCTCATCAACGACTTCACCGTCAAGCAGATGAGACAATGGGCCTTCCTGGTGAACACAGCCCG	Seq Length=110

TGGTACTAGTAGCAAATATTCAAACGAGAACTCTAGGAGAAGGCGAATTTGGAAGGGAGAGCGTCGAGATCC	Seq Length=72

NCCTTGCACTGCGGCCTCAACGAGCACAACCACCACCTCANNAACGACTTCACCGTCAAGCAGATGAGACAAGGGGCCTTCCTGGTGACACAGCCCG	Seq Length=97

CGATTCCTGAAGCTGACAGCATTCGGGCCGAGATGTCTCGCTCCGTGGCCTTAGCTGTGCTCGCGCTACTCTCTCTTTCTGGCCTGGAGGCTATCCAGCGTACTCCAAAGATTCAGGTTTACTCACGTCATCCAGCAGAGAATGGA	Seq Length=146

CTCTTTCTGGCCTGGAGGCTATCCAGCGTACTCCAAAGATTCAGGTTTACTCACGTCATCCAGCAGAGAATGGA	Seq Length=74

TTCTTGCCTGGAGGCTATCCAGCGTACTCCAAAGATTCAGGTTTACTCACGTCATCCAGCAGAGAATGGA	Seq Length=70

ACTGATTCAGGTTTACTCACGTCATCCAGCAGAGAATGGA	Seq Length=40

TTATGGCCTGGAGGCTATCCAGCGTACTCCAAAGATTCAGGTTTACTCACGTCATCCAGCAGAGAATGGA	Seq Length=70

ACTTCCTTGTCGGATGGCGTGGAGCGGGCGCTGGGGCTGCAGCGTGTCAGCACCCTGCAGGACCTGCTCTTCCACAGCGACTGCGTGACCCTGCACTGCGGCCTCAACGAGCACAACCACCACCTCATCAACGACTTCACCGTCANGC	Seq Length=148

TCTCGCTCCGTGGCCTTAGCTGTGCTCGCGCTACTCTCTCTTTCTGGCCTGGAGGCTATCCAGCGTACTCCAAAGATTCAGGTTTACTCACGTCATCCAGCAGAGAATGGA	Seq Length=111

GGTTTGGTAGTNGTTTTGACAACATCGACATCAAGTCGGCCGGGGATTTAGGCATTGCCGTCTGCAACGTGCCCGCGGCGTCTGTGGAGGAGACGGCCGACTCGACGCTGTGCCACATCCTGAACCTGTACCGGCGGGCCACCTGGATGCA	Seq Length=151

ACTGCTGTCGGATGGCGTGGAGCGGGCGCTGGGGCTGCAGCGTGTCAGCACCCTGCAGGACCTGCTCTTCCACAGCGACTGCGTGACCCTGCACTGCGGCCTCAACGAGCACAACCACCACCTCATCAACGACTTCGCCGTCAAGCAGATG	Seq Length=151

GTGCCCGCGCTACTCTCTCTTTCTGGCCTGGAGGCTATCCAGCGTACTCCAAAGATTCAGGTTTACTCACGTCATCCAGCAGAGAATGGA	Seq Length=90

AGGCAGTGGCGCTGCGGGCCAAGGCCTTAGGCTTCAACGTGCTCTTCTACGACCCTTACTTGTCGGATGGCGTGGAGCGGGCGCTGGGGCTGCAGCGTGTCAGCACCCTGCAGGACCTGCTCTTCCACAGCGACTGCGTGACCCTGCA	Seq Length=148

AGGCAGTGGCGCTGCGGGCCAAGGCCTTAGGCTTCAACGTGCTCTTCTACGACCCTTACTTGTCGGATGGCGTGGAGCGGGCGCTGGGGCTGCAGCGTGTCAGCACCCTGCAGGACCTGCTCTTCCACAGCGACTGCGTGACCCTGCA	Seq Length=148

AGGCAGTGGCGCTGCGGGCCAAGGCCTTAGGCTTCAACGTGCTCTTCTACGACCCTTACTTGTCGGATGGCGTGGAGCGGGCGCTGGGGCTGCAGCGTGTCAGCACCCTGCAGGACCTGCTCTTCCACAGCGACTGCGTGACCCTGCA	Seq Length=148

GGTGGGGCGATNCTGGCGCTGAGTACGTAGTGGAGTCCACTGGCGTCTTCACCACCATGGAGAAGGCTGGGGCTCATTTGCAGGGGGGAGCCAAAAGGGTCATCATCTCTGCCCCCTCTGCTGATGCCCCCATGTTCGTCATGGGTGTGAA	Seq Length=151

CAAGTGTGGCGATGATGGAGCTGATTACGTCGTGGAGTCCACTGGCGTCTTCACCACCATGGAGAAGGCTGGGGCTCATTTGCAGGGGGGAGCCAAAAGGGTCATCATCTCTGCCCCCTCTGCTGACGCCCCCATGTTCGTCATGGGTGTG	Seq Length=151

TTCTGGCCTGGNAGCTATCCAGCGTACTCCAAAGATTCAGGTTTACTCACGTCATCCAGCAGAGAATGGA	Seq Length=70

AGGTTGGCAAGGTGAATAGACGGCTGGAGTGTGAGGAAGGGAGAGCGACGAGCTACAACCCAAGAGGAGATTGAAAGATAGGAAGAGAACACGTATGAACTAGAGTAAAGAGTTTATCTCNTATGCCGGCTTCTGATGGAACAACAAAAAA	Seq Length=151

GTTCTGGCCTGGAGGCTATCCAGCGTAANCCAAAGATTCAGGTTTACTCACGTCATCCAGCAGAGAATGGA	Seq Length=71

GGTTTTGGTCGTATTGGGCGCCTGGTNNNCAGGGCTGCTTTTAACTCTGGTAAAGTGGATATTGTTGCCATCAATGACCCCTTCATTGACCTCAACTACATGGTTTACATGTTCCAATATGATTCCACCCATGGCAAATTCCATGGCACCG	Seq Length=151

GCTGCATTCGGGCCGAGATGTCTCGCTCCGTGGCCTTAGCTGTGCTCGCGCTACTCTCTCTTTCTGGCCTGGAGGCTATCCAGCGTACTCCAAAGATTCAGGTTTACTCACGTCATCCAGCAGAGAATGGA	Seq Length=131

CGAAGCTGACAGCATTCGGGCCGAGATGTCTCGCTCCGTGGCCTTAGCTGTGCTCGCGCTACTCTCTCTTTCTGGCCTGGAGGCTATCCAGCGTACTCCAAAGATTCAGGTTTACTCACGNCATCCAGCAGAGAATGGA	Seq Length=139

CTTCTGGCTTGGAGGCTATCCAGCGTACTCCAAAGATTCAGGTTTACTCACGTCATCCAGCAGAGAATGGA	Seq Length=71

NTCTGGCCTGGAGGCTATCCAGCGTACTCCAAAGATTCAGGTTTACTCACGTCATCCAGCAGAGAATGGA	Seq Length=70

GACTATCCCAATTTCCAAGGGAGGCTGNNGAATTTTAGAATACAATTTTCATGATTAGCTTTGATCAATTGCGTGGGACTGGGAACCTGGCCTCCAAGAAATAAATCGAAAGCAAGGAGATGGAGAAAACATATTGAAAAGAAAATTTTGA	Seq Length=151

ACCACGCCATCACTCTCACCAGGGAGGACCTGGAGAAGTTCAAAGCCCTCCGCATCATCGTCCGGATTGGCAGTGGTTTTGACAACATCGACATCAAGTCGGCCGGGGATTTAGGCATTGCCGTCTGCAACGTGCCCGCGGCGTCTGTTGA	Seq Length=151

TTGTGACCTGGAGGCTATCCAGCGTACTCCAAAGATTCAGGTTTACTCACGTCATCCAGCAGAGAATGGA	Seq Length=70

TTTCTTGCCTGGAGGCTATCCAGCGTACTCCAAAGATTCAGGTTTACTCACGTCATCCAGCAGAGAATGGA	Seq Length=71

NTCTGGCCTGGAGGCTATCCAGCGTACTACAAAGATTCAGGTTTACTNACGTCATCCAGCAGAGAATGGA	Seq Length=70

CCAAAGATTCAGGTTTACTCACGTNNNNNNNCAGAGAATGGA	Seq Length=42

CCACCATTACACTCTTTCCCTACACGNNNNTCTTCCCGAA	Seq Length=40

ATTCTGTCCTGGAGGCTATCCAGCGTACNCCAAAGATTCAGGTTTACTCACGTCATCCAGCAGAGAATGGA	Seq Length=71

GGAATAAATGAAGATGAAAGCATTCGGGCCGAGATGTCTCGCTCCGTGGCCTTAGATGTGCTCGCGCTACTCTCTCTTTCTGGCCTGGAGGCTATCCAGCGTACTCCAAAGATTCAGGTATACTCACGTCATCCAGCAGAGAATGGA	Seq Length=147

TTCGTGCCTGGAGGCTATCCAGCGTACTCCAGGGATTCAGGTTTACTCACGTCATCCAGCAGAGAATGGA	Seq Length=70

GGCTGACAGCATTCGGGCCGAGATGTCTCGCTCCGTGGCCTTAGCTGTGCTCGCGCTACTCTCTCTTTCTAGCCTGGAGGCTATCCAGCGTACTCCAAAGATTCAGGTTTACTCACGTCATCCAGCAGAGAATGGA	Seq Length=136

GACTTGGAGGCTATCCAGCGTACTCCAAATATTCAGGTTTACTCACGTCATCCAGCAGAGNATGGA	Seq Length=66

ATCACCATCTTCCAGGAGCGAGATCCCNNCAAAATCAAGTGGGGCGATGCTGGCGCTGAGTACGTCGTGGAGTCCACTGGCGTCTTCACCACCATGGAGAAGGCTGGGGCTCATTTGCAGGGGGGAGCCAAAAGGGTCATCATCTCTGCC	Seq Length=150

CATTTGCAGGGGGGAGCAAAAAGGGTCATAATCTCTGCCCCCTCTGCTGACGCCCACATGTTCGTCATGGGTGTGAACCA	Seq Length=80

GGGGCATTCCTGAAGCTGACAGCATTCGGGCCGAGATGTCTCGCTCCGTGGCCTTAGCTGTGCTCGCGCTACTCTCTCTTTCTGGCCCGGAGGCTATCCAGCGTACTCCAAAGATTCAGGTTTACTCACGTCATCCAGCAGAGAATGGAAG	Seq Length=151

CATAACAAGGAGAACAAATTCCGGGACCGCTCGTTTAGCGAGAACGGCGATCGCAGCCAGCACCTCCTGCACCTGCAGCAGCAGCAGAAGGGGGGCGGCGGCTCCCAGATCAACTCCACGCGCTACAAGACCGAGCTGTGCCGGCCCTTCG	Seq Length=151

TGTTCGGGCTGTCAGGAGGCGACACGAGGCCCAGCGCTGCCCCCTCCCGCCTCCTGACAGCCCGGACCAGTCTCTGCAGTGGCGCTGCGGGCCAAGGCCTTCGGCTTCAACGTGCTCTTCTACGACCCTTACTTGTCGGATGGCGTGGAG	Seq Length=150

CCGGGGCTGCTTTTAACTCTGGTAAANNNNNTATTGTTGCCATCAATGACCCCTTCATTGACCTCAACTACATGGTTTACATGTTCCAATATGATTCCACCCATGGCAAATTCCATGGCACCGTCAAGGCTGAGAACGGGAAGCTTGTCAT	Seq Length=151

GACCTCGGGAAAAACTGACTCTGCGTNNNNTGCTGGGAAGTGGAGCCTTTGGAGAAGTGTATGAAGGAACAGCAGTGGACATCTTAGGAGTTGGAAGTGGAGAAATCAAAGTAGCAGTGAAGACTTTGAAGAAGGGTTCCACAGACCAGGA	Seq Length=151

AATGCACTGCGGCCTCAACGAGCACAACNCCACCTCATCAACGACTTCACCGTCAAGCAGATGAGACAAGGGGCCTTCCTGGTGAACACAGCCCG	Seq Length=95

GGGGCATTCCTGAAGCTGACAGCATTCGTGCCGAGATGTCTCGCTCCGTGGCCTTAGCTGTGCTCGCGCTACTCTCTCTTTCTGGCCTGGAGGCTATCCAGCGTACTCCAAAGATTCAGGTTTACTCACGTCATCCAGCAGAGAATGGAAG	Seq Length=151

GGCACGTCAAGGCTGAGAACGGGAAGCTTGTCATCAATGGAAATCCCATCACCATCTTCCAGGAGCGAGATCCCTCCAAAATCAAGTGGGGCGATGCTGGCGCTGAGTACGTCGTGGAGTCCACTGGCGTCTTCACCACCATGGAGAAGG	Seq Length=150

TTTCTGCCCTGGAGGCTATCNAGCGTNNNNCAAAGAGTCAGGTTTACTCACGTCATCCAGCAGAGAATGGAAGATCGGAAGAGAAAACGTCTGAACTCGAGTAACGTGTTTATCTGGTATGGAGGAGGCGGGTTGAAAACCAAACAAGGAG	Seq Length=151

TTTCTGGCCTGGAGGCTATCNAGCGTANNCCAAAGATTCAGGTTTACTCACGTCATCCAGCAGAGAATGGA	Seq Length=71

GTTACTAGTCGGATGGCGTGGAGCGGGCGCTGGGGCTGCAGCGTGTCAGCACCCTGCAGGACCTGCTCTTCCACAGCGACTGCGTGACCCTGCACTGCGGCCTCAACGAGCACAACCACCACCTCATCAGCGACTTCACCGTCAAGC	Seq Length=147

GCCCCATAAGATCGGAAAGCCCCCTTCTTCCCTCCAGTCACGTGTTTATCTCGTATGCCGTCTTCTGCTTGAAAAAAAAAAAAAAAACAAAAAAAACAAAAAAAAACAAGATACAAGAAAAAAAATAAAAAAAAAAAAAGAAAAAAAACAA	Seq Length=151

TGGGGCATTCCTGAAGCTGCCCGCCTTCTTTCCGAGATGTCTCGCTCCGTGGCCTTAGCTGTGCTCGCGCTACTCTCTCTTTCTGGCCTGGAGGCTATCCAGCGTACTCCAAAGATTCAGGTTTACTCACGTCATCCAGCAGAGAATGGAA	Seq Length=151

AGATTCCTGAAGCTGACAGCATTCGGGCCTAGATGTCTAGCTACGTGGCCTTATCTGTGCTCGCGCTACTCTCTCTTTATGGCCTGGAGGCTATCCAGCGTAATCAAAAGATAAGGGTTTACTCACGTAATCCAGCAAAGAAAGGA	Seq Length=146

TGGGGCATACCTGAAGCTGACAGCATTCTGGCCGAGATGTCTCGCTCCGTGGCCTTAGCTGTGCTCGCGCTACTCTCTCTTTCTGGCCTGGAGGCTATCCAGCGTACTCCAAAGATTCAGGTTTACTCACGTCATCCAGCAGAGAATGGAA	Seq Length=151

GTTCCTGAAGCTGACAGCATTCGGGCCGAGATGTCTCGCTCCGTGGCCTTAGCTGTGCTCGCACTACTCTCTCTTTCTGGCCTGGAGGCTATCCAGCGTACTCCAAAGATTCAGGTTTACTCACGTCATCCAGCAGAGAATGGA	Seq Length=144

CCAGCGTACTCCAAAGATTCAGGTTTACTCACGTCATCCAGCAGAGAATGGA	Seq Length=52

CAAGCAGATGAGACAAGGGGCCTTCCTGGTGAACACAGCCCG	Seq Length=42

CTCCAAAATCAAGTGGGGCGATGCTGGCGCTGAGTACGTCGTGGAGTCCACTGGCGTCTTCACCACCATGGAGAAAGCTGGGGCTCATTTGCAGGGGGGAGCCAAAAGGGTCATCATCTCTGCCCCCTCTGCTGATGCCCCCATGTTCGT	Seq Length=150

TTTCCTTATCTTTGCTCGCGCTACTCNNNCTTTCTGGCCTGGAGGCTCTCCAGCGTACTCCAAAGATTCAGGTTTACTCACGTCATCCAGCAGAGAATGTA	Seq Length=101

TTCTGGCCTGGAGGCTATCCAGCGTACTCCAAAGATTCAGGTTTACTCACGTCATCCAGCAGAGAATGGA	Seq Length=70

GGGGCATTCCTGAAGCTGACAGCATTNNNGCCGAGATGTCTCGCTCCGTGGCCTTAGCTGTGCTCGCGCTACTCTCTCTTTCTGGCCCGGAGGCTATCCAGCGTACTCCAAAGATTCAGGTTTACTCACGTCATCCAGCAGAGAATGTAAG	Seq Length=151

GATAACACCCATGGCAAATTCCATGGCACCGTCAAGGCTGAGAACGGGAAGCTTGTCATCAATGGAAATCCCATCACCATCTTCCAGGAGCGAGATCCCTCCAAAATCAAGTGGGGCGATGCTGGCGCTGAGTACGTCGTGGAGTCCACTT	Seq Length=151

TNTGGCCTGGAGGCTATCCAGCGTACTCCAAAGATTCAGGTTTACTCACGTCATCCAGCAGAGAATGGA	Seq Length=69

GATTCCTGAAGCTGACAGCATTCGGGCAGAGATGTATCGCTCAGTGGCCTTAGCTGTGCTAGCGCTACTCTCTCTGTATGGCCTGCAGGCTATCAAGAGTGCTCAAAAGATTCAGGTTTACTCACGTCATCCAGCAGATACTGGA	Seq Length=145

NCTGGCCTGGAGGCTATCCAGCGTACTCCAAAGATTCAGGTTTACTCACGTCATCCAGCAGAGAATGGA	Seq Length=69

CATTGTGGCCTGGAGGCTATCCAGCGTACTCCAAAGATTCAGGTTTACTCACGTCATCCAGCAGAGAATGGA	Seq Length=72

TGTTTAATCACGTCATCCAGCAGAGAATGGA	Seq Length=31

ACCTTAGCTGTGCTCGCGCTACTCTCNNNNNCTGGCCTGGAGGCTATCCAGCGTACTCCAAAGATTCAGGTTTACTCACGTCATCCAGCAGAGAATGGA	Seq Length=99

ATTCCTGAAGCTGACAGCATTCGGGCCGAGATGTCTCGCTCCGTGGCCTTAGCTGTGCTCGCGCTACTCTCTCTTTCTGGCCTGGAGGCTATCCAGCGTACTCCAAAGATTCAGGTTTACTCACGTCATCCAGCAGAGAATGGA	Seq Length=144

CAGGGGCATTCCTGAAGCTGACAGCATTCGGGCCGAGATGTCTCGCTCCGTGGCCTTAGCTGTGCTCGCGCTACTCTCTCTTTCTGGCCTGGAGGCTATCCAGCGTACTCCAAAGATTCAGGTTTACTCACGTNATCCAGCAGAGAATGGA	Seq Length=151

TCACCACCCCATCAACGACTTCACCGTCAAGCAGATGAGACAAGGGGCCTTCCTGGTGAACACAGCCCG	Seq Length=69

AAGATAGCCAAATGCCTCGTCATCTAATTAGTGACGCGCATGAATGGATGAACGAGATTCCCACTGTCCCTACCTACTATCCAGCGAAACCACAGCCAAGGGAACGGGCTTGGCGGAATCAGCGGGGAAAGAAGACCCTGTTGAGCTTGA	Seq Length=150

ATTACCTCGGATGGCGTGGAGCGGGCGCTGGGGCTGCAGCGTGTCAGCACCCTGCAGGACCTGCTCTTCCACAGCGACTGCGTGAACCTGCACTGCGGCATCAACGAGCACAACCACCAAATAATCAACTACTCAAGAGTAAAGCAGATGA	Seq Length=151

CACCTGGCCTGGAGGCTATCCAGCGTACTCCAAAGATTCAGGTTTACTCACGTCATCCAGCAGAGAATGGA	Seq Length=71

AAGAAAAATAATTGTCGGATGGCGTGGAGAGGGCGCTGGGGATGCAGAGTGTCAGAACCCTGCAGGACCTGCTCTTCCACAGCGACTGCGTGACCCTGCACTGCGGCCTCAACGAGCACAACCACCACCTCATCAACGACTTCACCGTCAA	Seq Length=151

GAGTCCACAGGCGTCTTCACNACCATANNNAAGGCTGGGGCTCATTTGCAGGGGGGAGCCAAAAGGGTCATCATCTCTGCCCCCTCTGCTGATGCCCCCATGTTCGTCATGGGTGTGAACCA	Seq Length=122

CTTCTGGCCTGGAGGCTATCCAGCGTACTCCAAAGATTCAGGTTTACTCACGTCATCCAGCAGAGAATGGA	Seq Length=71

GTGGCCTCAGCTGTGCTCGCGCTACTCNNTCTTTCTGGCCTGGAGGCTATCCAGCGTACTCCAAAGATTCAGGTTTACTCACGTCATCCAGCAGAGAATGGA	Seq Length=102

ACTTTCAGGCCAGGAGGCTATCCAGCGTACTCCAAAGATGGAGGATTAATCACGTCATCAAGAAGAGAATGGAAGATAAGAAGAGCAGAAGAATGAAATCCAAGAACTTGTTTAACTCGTATGCCGTCTTCTGCTTGAAAAAAAAAAAAAA	Seq Length=151

GTGTCTCGCTCCGTGGCCTTAGCTGTGCTCGCGCTACTCTCTATTTCTGGCCTGGAGGATATACAGCGTAATCCAAAGATTCAGGTTTACTCACGTCATCCATAATATAATGGT	Seq Length=114

ATGAACATGAGATCGGAAGAGCACACGTCTGAAATACAGTAAAGAGTATAACTCGTATGCCGTCTACTGCTTGAAAAAAAAAAATCAAAAAAATTAAATTAAAAAAAAAGAGAAACCTAATATCACATATCACACAAACACCAACAAAACA	Seq Length=151

GGTTTACTCACGTCATCCAGCAGAGAATGGA	Seq Length=31

ATCCAGAGGACACCAAAGATTCAGGTTTACTCAAGTCATCAAGAAGAGAATGGAAGATAGGAAGAGCACACGTCAGAACTCAAGTCAAGTGTTTATAACGTATGACGAAGTAGGATTGAAAAACACACACCAAACAAACACCAACAAATAA	Seq Length=151

ATCTGCAACCTATGCTGACGCCCCCATGTTCGTAATGAGTGTGAAACAAGATCGGAAGAGCACACGCATGAACTCAAGTAAAGTGTATATCTCGTAAGCCGAATAATGAGTGAAACAAAAAAACACACACATTTCAAACCCTAACAAAAAA	Seq Length=151

TGTGGCAAGGAGGCTATCCAGCGTACTCCAAAGATTCAGGATTAATAAAGTCATCCAGCAGAGAATGGAAGATAGGAAAAGAACACGTAAGAACAACAGTAAAGAGTTTATATAGTATGCCGTCTTCTGCTTGNAAAAAAAAAAAAAAAAA	Seq Length=151

ANTCTGGGCTGGAGGCTATCCAGCGTACTCCAAAGATACAGGATTACAAAAGTCATACAGCAGAGAATGGAAGACAGGAAGAGCACAAGTCTGAACAACAGTAAAGTGAGTAGAACGTATGCCGACTTCTGCTTGAAACAACAACAAAAAA	Seq Length=151

TTCTGGCGTGGGGGCTATCCAGCGTACTCCAACGATTCAGGTTTAATAACGTCCTCCCGCAGAGACTGGTCGAACGGAAGAGCACACGTATGACGTCCAGTCACGTGTTTAAATAGTATGACGTATTCGGCTTGAAAAAAAAAAAAAA	Seq Length=148

CACCTGGCCTGGAGGCTATCCAGCGTNNNCCAAATATTCAGGTTTACTCACGTCATCCATCAGAGAATGGAAGATCTTAATAGCACACGTCTGAACTCCATTCACTTTTTTATCTCGTATGCCGTCTTCTGCTTGAAAAAAAAAAAAAAAA	Seq Length=151

GAGTACAGCGTGGAGTCCACTGGCGTCTTCACCACCATGGAGAAGACTGGGGCTCATTTGCAGGGGGGAGCCAAAAGGGTCATCATCTCTGCCCCCTCTGCTGATGCCCCCATGTTCGTCATGGGTGTGAACCA	Seq Length=134

CTCTTTCTGGCCTGGAGGCTATCCAGCGTACTCCAAAGATTCAGGTTTACTCACGTAATCCAGCAGAGAATGGA	Seq Length=74

TCATTCCTGAAGCTGACAGCATTCGGGCCGAGATTTCTCGCTCCTTGGCCTTAGCTGTTCTCGCGCTACTCTCTCTTTCTTGCCTGGATGCTATCCAGCGTACTCCAACGATTCATGTTTACTCACGTCATCCAGCAGAGAATGGA	Seq Length=146

CTGCCCCCTCTGCTGATGCCCCCATGTTCGTCATGGGTGTGAACCA	Seq Length=46

GATAGAGGAATTATGAGGGAAAGATACCAAGTCACGGTTTATTCTTCAAAATGGAGGTGGCTTGTTGGGAAGGTGGAAGCTCATTTGGCCAGAGTGGAAATTGAATTGGGAGAAATCGATGACCAAATGTAAACACTTTGTTCTTTATATA	Seq Length=151

TGATGGAATGGAGGATATAAAGAGTAATAAAAAGATTCAGGTTTACTAACGTCATACAGAAGAGAAGGGAAGATAGGAAGAGCACAAATATGAAATAAAGTCAAGTGTTTATCTGGTATGCCGTCTTCTGCTTGAAAAAAAAAAAAAAAAA	Seq Length=151

CCAAATTCAATTTTGGCGATGCTGGCGCTGAGTACGTCGTAGAGTCCACTGGCGTCTTCACCACCATTGAGAAGGCTGGGGCTCATTTGCAGTTGGGAGCCAAAAGGGTCATCATCTCTGCCCCCTCTGCTGATGCCCCCATGTTCGTCAT	Seq Length=151

GACCTGTTCATTCAGCAATAGACGGCTTTAGTTTGAGGAGTGTGGCGGCCTGGGCTCCCCAACAGTCAGGTGTGAGTGGAGGCAAGGAGATGTCAAAGGGATCACCAGGAACTTCTCCACCCGCTCTCCCAGCACCA	Seq Length=137

CGCGTTTTCTTCTGGCGTTGCGCGGTCGCTGGGGCTTCAGCGTTTCCTCCCCCTGCAGGCCCTGCTCTTCCACAGCTACTTCTTTACCCTGCACTTCTGCCTCAACTCTCCCCACCACCACCTCATCCACGCCTTCACCGTCAATCAGATT	Seq Length=151

TTCTTGCCTTTATTCTATCCAGCGTACTACAAAGATTCAGGTTTACTCACGTCATCCAGCAGATAATTGA	Seq Length=70

CTGGTAATAATATATGAAACCTCTGCTGACGCACCCATTTTCTTCATGGTTGTGAAAAAATATAGGAAGAGAAAACTTCTGAACTCCATGCACGTTTTTATCTCTTATGCCGTCTTCTGCTTGAAAAAAAAAAAAAAAAATAACTAAAATA	Seq Length=151

GTTGCATTCCTTAAGCTGACAGCATTCTNTCCGATATGTCTCTCTCCGTGGCCTTAGCTGTGCTCGCGCTACCCTCTCTTTCTGGCCTGTATTCTATCCAGCGGACTCCAAAGATTCGGGTTTACTCACGTCATCCAGCAGAGAATGGAAG	Seq Length=151

GTTTACGATGTTAGTCGCCGTGCCTACCNTGGTGACCACGGGAGACGGCTTGAGTGTGATGAAGGGGGAGCGGCG	Seq Length=75

CAATTTTCTTTTCTCGCGCTACTCTCTCTTTCTGGCCTGGAGGCTATCCAGCGTCCTCCAAAGATTAAGTTGTACTCACGTCATCCAGCATATAATGGA	Seq Length=99

CTGACCACTATGCTGACGCAACCATGNNNNNCATGGGTGTGCACCAAGATAGGAAGAGAACACGTATGAACTCCATTCAAGAGTTTATATCGTATGCAGTATTCTGATTGAAAAAAAAAAAATAAAACACATAACACACATCAACTTT	Seq Length=148

GGGGAAATAATAAAGCTGACAGCATTCGGGCCGAGATGTCTCGCTACGTGGCCTTAGATGTGCTCGAGCTACTCTCTCTTTATGGCATGGAGGATATACAGAGTAATAAAAAGATTCAGGTTTACTCAAGTCATCAAACAGAGAATGGAAG	Seq Length=151

TTCCTTGCCTTGATGCTATCCATCGTNNNCCAAAGATTCCGGTTTACTCACTTCATCCAGCAGAGAATGGA	Seq Length=71

GTTCCTTCCTTAATCTTACATCATTCGTGCCTAGATGTCTCGCTCCGTGGCCTTAGCTGTGCTCGCGCTACTCTCTCTTTCTGGCCTGGATTCTATCCAGCGTACTCCAAAGATTCAGGTTTACTCACGTCATCCAGCAGAGAATGGA	Seq Length=148

GCTTTTCAATTCCTTCTTCTTCAACTTTCTCTTCTACGACCCTTCCTTGTCTTATGGCGTGTAGCGGGCGCTGGGGCTGCAGCGTGTCATCACCCTGCAGGACCTGCTCTTCCACAGCGANTGCGTGACCCTGCACTGCGGCCTCAACGAG	Seq Length=151

GCGTGACCCTGCACTGCGGCCTCAACGAGCACAACCACCACCTCATCAACGACTTCACCGTCAAGCAGATGAGACAAGGGGCCTTCCTGGTGAAAACAGCCCG	Seq Length=103

CCTGCCCCCTCTGCTGATGCNCCCATGTTCGTCATGGGTGTGAACCA	Seq Length=47

CAGAAGGATGGCGTGGAGCGNGCGCTGGGGCTGCAGCGTGTCAGCACCCTGCAGGACCTGCTCTTCCACAGCGACTGCGTGACCCTGCACTGCGGCCTCAACGAGCACAACCACCACCTCATCAACGACTTCACCGTCAAGCAGATG	Seq Length=147

GGAAATCCCATCACCATCTTNCAGGANNNNGATCCCTCCAAAATCAAGTGGGGCGATGCTGGCGCTGAGTACGTCGTGGAGTCCACTGGCGTCTTCACCACCATGGAGAAGGCTGGGGCTCATTTGCAGGGGGGAGCCAAAAGGGTCATCA	Seq Length=151

TTCATGGCCTGGAGGCTATAAAGAGTNNNAAAAAGATTCAGGTTTACTCACGTCATCCAGCAGAGAATGGA	Seq Length=71

ATGCCCGTCTGATGACTCCCCCATGTCCGTCCTGGGTGTGAAACAAGATCGTCCTCGCACACGTCTGAACTCCAGTCAAGTGGTTATCTCGTATGCCGGATGATTCTGGAAAAAAAAAAGGAAAAAAAAAAAAGGAAAGAAAAAGGGGAGG	Seq Length=151

TCTGCCTGGAGGCTATCCAGNGTACTCCAAAGATTCAGGTTTACTCACGTCATCCAGCAGAGAATGGA	Seq Length=68

CCATGCACTGCGGCCTCAACGAGCACANNCACCACCTCATCAACGACTTCACCGTCGAGCAGATGAGACAAGGGGCCTTCCTGGTGAACACAGCCCG	Seq Length=97

TTAGGCTGAGAACGGGAAGCTTGTCATCAATGGAAATCCCATCACCATCTTCCAGGAGCGAGATCCCTCCAAAATCAAGTGGGGCGATGCTGGCGCTGAGTACGTCGTGGAGTCCACTGGCGTCTTCACCACCATGGAGAAGGCTGGGG	Seq Length=149

GTGTACTCCAAAGATTCAGGNTTACTNNNNNCATCCAGCAGAGAATGGA	Seq Length=49

GGCCTGGATGCTATCCAGCGTACTCCAAAGATTCAGGTTTACTCACGTCATCCAGCAGAGAATGGA	Seq Length=66

GCATTCCAGAAGCTGACAGCATTCGGGCCGAGATGTCTCGCTCCGTGGCCTTAGCTGTGCTCGCGCTACTCTCTCTTTCTGGCCTGGAGGCTATCCAGCGTACTCCAAAGATTCAGGTTTACTCACGTCATCCAGCAGAGAATGGA	Seq Length=146

GCGTACTCCAAAGATTCAGGTTTACTNNNNNCATCCAGCAGAGAATGGA	Seq Length=49

CCTCCAAAGTCAAGTGGGGCTATGCTGGCGCTGAGTACGTCGTGGAGTCCACTGGCGTCTTCACCACCATGGAGAAGGCTGGGGCTCATTTGCAGGGGGGAGCCAAAAGGGTCATCATCTNTGCCCCCTCTGCTGACGCCCCCATGTTCGT	Seq Length=151

ACATAAAAAGAATTTCCGGTGGAAGATGAGATCGGAAGAGCAAACGTATGACCTCCATTCACGTGTTTATCTCGTATGACGACTTCGGCTTGAAAAAAACAAAAAAAAAAAAAAATTACGTTTACTGCATTAAGAGGGATACGAAAAAAAT	Seq Length=151

TACTGGCCCGGAGGCTATCCAGCGTANNNCAAAGATTCAGTTTTACTCACGTCATCCAGCAGAGAATGGA	Seq Length=70

CATCCGCGGGGAGACCTTGGGCATCATCGGACTTGGTCGCGTGGGGCAGGCAGTGGCGCTGCGGGCCAAGGCCTTCGGCTTCAACGTGCTCTTCTACGACCCTTACTTGTCGGATGGCGTGGAGCGGGCGCTGGGGCTGCAGCGTGTCAG	Seq Length=150

GTCCACTGGCGTCTTCACCACCATGGANNAGGCTGGGGCTCATTTGCAGGGGGGAGCCAAAAGGGTCATCATCTCTGCCCCCTCTGCTGACGCCCCCATGTTCGTCATGGGTGTGAACCA	Seq Length=120

TTTTTTCTTTCTTCTCTCCCTCTTACTCCCCCTCTTCATTTTTCCTCCCCTCATCCCTCAGCTCCTTTCCGATCTTCAGCTCACACGTCTTCCCTCCCGTCACGTGTTTCTCTCTTCTGCCGTCTTCATCTTGCAAAAAAACCAAACCCA	Seq Length=150

GGCTTAATCCAAAGATTCAGGTTTACTCACGTCATCCAGCAGAGAATGGAATCTCGGCAGAGAACACGTCTGAAGTAAAGTCACGTGGGTATCTAGAATGCGGGATTATGCTTGACAAAAAAAAAATAAAGTGATAAAAAAAGGTTAATAA	Seq Length=151

CCATTCCTGAAGCTGACAGCCTTCGGNNNGAGATGTCTCGCTCCGTGGTCTTAGCTGTGCTCGCGCTACTCTCTCTTTCTGGCCTGGAGGCTATCCCGCGTACTCCACAGATTCAGGTTTCCTCCCGTCCTCCAGCAGAGAATGGA	Seq Length=146

TGATGCCTGGAGGCTATCCAGCGTACTCCAAAGATTCAGGTTTACTCACGTCATCCAGCAGAGAATGGA	Seq Length=69

CTGTCTTTCTGGCCTGGAGGCTATCCAGCGTACTCCAAAGATTCAGGTTTACTCACGTCATCCAGCAGAGAATGGA	Seq Length=76

TTGCTGGCCTGTAGGCTATCCAGCGTACTCCAAAGATTCATGTTTACTCACGTCATCCAGCAGAGAATGGA	Seq Length=71

GACAGCAATCGGGCCGAGATGTCTCGNNNCGTGGCCTTAGCTGTGCTCGCGCTACTCTCTCTTTCTGGCCTGGAGGCTATCCAGCGTACTCCAAAGATTCAGGTTTACTCACGTCATCCAGCAGAGAATGGA	Seq Length=132

GTGCCTGGTGGCTATCCAGCGTACNNNNNNNATTCCGTTTTACTCACGTCATCCAGCAGAGAATGGA	Seq Length=67

ATTTGGCCTGGAGGCTATCCAGCGTACTCCAAAGATTCAGGTTTACTCACGTCATCCAGCAGAGAATGGA	Seq Length=70

GGACTTGGCTGTGCTCGCGCTACTCTCTCTTTCTGGACTGTATGCTATCCAGCGTACTCCAAAGATTCAGGTTTACTCACTTAATCCAGCAGAGAATTGAAGATCGGAAGATCACACGTCTGCAATCAAGTAACGAGATTATATCGTATG	Seq Length=150

CTCTTTCTGGACTGTCGGCTATCCAGCGTACTCCAAAGATTCAGGTTTACTCCCGTCATCCAGCAGAGAATGGAAGATAGTAAGAGCACACGTCTGAACACAAGTAAAGATTTTATCTCGTATGAAGACATATGCTTGAAACAAAAAAACA	Seq Length=151

NGATTGCGGATTGCGTGGAGCGGGCGCTGGGGCTGCAGCGTTTCAGCACAATGCAGGAGCTTGTCTTTCCCCTCTAATGGGTGACCATGCACTGCGGACTAAACGAGAACAACAACCACCNCATCAACGACTTCACCGTCAAGAAGATGAG	Seq Length=151

NTTCCCCCTCTGCTGCTGCCCCCATGTTCTTCATGGGTGTNNCCCACNATCGGACTCGCACCCGTCTGACCTCCCGTCCCGTGTTTATCTCTTATGCCGTCTTCTGCTTGAAAAACCCCANCCCCCACCACAACCCAAAAACAATACTC	Seq Length=149

TCACTGGCCTGGAGGCTATCCAGCGTACTCCAAAGCTTCCGGTTTACTCACGTCATCCAGCAGCGAATGGACGATCGGCCGAGCACACGTCTGAACTCCCGTCACGTGTTTATCTCGTATGCCGTCTTCTGCTTGACAAAACAAAACACAA	Seq Length=151

GGGCATTTCTGNAGCTGACAGCATTCGGGCCGAGATGTCTCGCTCCGTGGCCTTAGCTGTGCTCGCGCTACTCTCTCTTTCTGGCCTGGAGGCTATCCAGCGTACTCCAAAGATTCAGGTTTACTCACGTCATCCAGCAGAGAATGGA	Seq Length=148

AAGAGGATATTGTTGAAATAAATGAAAANTTAATTGAAAAAAAATAAATGGTTTAAATGTTCCAATATGATTAAACACAAGGCAAATTAAATGGCAAGGTAAAGGAGGAGAAAGGTAAGCTGGTAATAAATAGAAATACCATAACCATCTT	Seq Length=151

CGGGTCATTCCTGAAGCTGACAGCATTCGGGCCTATATGTCTCTCTCCGTGGCCTTAGCTGTGCTCGCGCTACTCTCTCTTTCTGGCCTGGAGGCTATCCAGCGTACTCCAAAGATTCAGGTTTACTCACGTCATCCAGCAGAGAATGGAA	Seq Length=151

TAAGATTCAGGTTTACTCACGTCATCCAGCAGAGAATGTA	Seq Length=40

GCCCCCTCTGCTGATGCCCCCATGTTCGTCATGGGTGTGAACCA	Seq Length=44

CTGTGCCTGGCGGCTATCCAGCGTACTCCAAAGATTCAGGTTTACTCACGTCATCCAGCAGAGAATGGA	Seq Length=69

CTGTGCTCGCGCTACTCTCTCTTTCTGGACTGGAGGATATCCAGCGTACTCCAAAGATTCAGGTTTACTCACGTCATAAAGCAGAGAATGGA	Seq Length=92

GGCCCTTGAGGCTATCCAGCGTACTCCNNAGATTCAGGTTTACTCACGTCATCCAGCAGAGAATGGA	Seq Length=67

GTATTCCAAAGATTCAGGTTTACTCACGTCATCCAGCAGAGAATGGA	Seq Length=47

GAGATTCCTGAAGCTGACAGCATTCGGGCCGAGATGTCTCGCTCCGTGGCCTTAGCTGTGNTCGCGCTACNCTCTCTTTCTGGCCTGGAGGCTATCCAGCGTACTNCAAAGATTCAGGTTTACTCACGTCATCCAGCAGAGAATGGA	Seq Length=147

GCCTGGCCTGGAGGCTATCCAGCGTACTACAAAGATACAGGTTTACTCACGTCATCCAGCAGAGAATGGA	Seq Length=70

NCTGGCCTGGAGGCCATCCATCGTACTCCAAAGATTCAGGTTTACTCACTTCATCCAGCATAGAATGGA	Seq Length=69

ATTCCTGAAGCTGACAGCATTCGGGCCGNGATGTCTCGCTCCGTGGCATAAGCTGTGCTGGGGCTACTCTCTCTTTAGGGCCTGGAGGATATCCAGAGTACTCAACAGATTCCTGTTTACTCACGTCATCCAGCATCTAATGGA	Seq Length=144

GGGCATTTCCGAAGCTGACAGCATTCGGGACGAGATGAATAGATAAGTGGACTTAGCTGTGTTCGCGCTACTCTCGATTTATNGCCTGGAGGCTATGANGAGTACTACAAAGATGCAGGNNTAATAACGTCATCCAGAAGAGAATGGANNA	Seq Length=151

GATCATGTGGGGCGATGCTGGCGCTGAGTACGTCGTGGAGTCCACTGGCGTCTTCACCACCATGGAGAAGGCTGGGTCTCATTTGCAGTGGGGATCCAAAAGTTTCATCATCTCTGCCCCCTCTGCTGATGCCCCCATGTTCGTCATGGGT	Seq Length=151

GATTCCTGAAGCTGACAGCATTCGGGCNNAGATGTCTCGCTCAGTGGACTTAGCTGTGCTAGCGCTACTCTCTCTTAGTGGCCTGGAGGCTATCAAGCGTACTAACACGATGCCGATTTACTCACGTACTCCAGCATAGAATGGA	Seq Length=145

TTCTGGCCTGGAGGCTATCCAGCGTACTCCAAAGATTCAGGTTTACTCACTTCATCCAGCAGAGAATGGA	Seq Length=70

AAGGGAAAGAGAGGAAGAGAATACTTCTGATCACCAGTCACGTTTCTATCTAGTAAGCCGTATTAGGCATGAAAAACAAAATGATGGAAAAAGCTAAAACATGTAAATGAAATCACCGTCACGATTGAAACCCTCCTAACTGTATGTTTT	Seq Length=150

AATAAAGATGATCTGAATAGAACACGTATGAAAGAAAGAAACGGGTATATATCTTAAGACGTATTCGGATTGAAAAAAAAAAAAACAAAAAAAAAAAAAAAAAACATGAAGAAGATAAAAATAAATATACAAAAAAGAGAAGGATATACAA	Seq Length=151

NCAATACTTAATCTGACATCATTCGGTCCTAGATGTCTCGCTCCGTGGCCTTAAATTTTCTCGCTCTACTCTCTCTTTCTGGCCTGGAGGCTAACCAGCGTACTCCAAAGATTCAGGTTTACTCACGTCATCCAGCAGAGAATGGA	Seq Length=146

TCTCACCAGGTAGGACCTGGAGAAGTTCAAAGCCCTCCGCATCATCGTCCTGATTGGCATNGTTTTTTAANACATCGACATCAAGTCGGCCGGGGATTTAGGCATTGCCGTCTGCAACGTGCCCGCGGCGTCTGTGGAGGAGACGGCCGA	Seq Length=150

TTTCAGGCCTGGAGGCTATCCAGCGTACTCCAAAGATTCAGGTTTACTCACGTCATCCAGCAGAGAATGGA	Seq Length=71

CATTCTGGCCTGGAGGCTATCCAGCGTNNTCCAAAGATTCAGGTTTACTCACGTCATCCAGCAGAGAATGGA	Seq Length=72

CTAGCCTGGAGGCTATCCAGCGTACTCCAAAGATTCATGTTTACTCACGTCANCCAGCAGCGAATGGA	Seq Length=68

GCCTAACCCTGCACTGCGGCCTCAACGAGCACAACCACCACCTCATCAACGACTTCACCGTCAAGCAGATGAGACAAGGGGCCTTCCTGGTGAACACAGCCCG	Seq Length=103

GTTCCGGCCTGGAGGCTATCCAGCGTACTCCAAAGATTCAGGTTTACTCACGTCATCCAGCAGAGAATGGA	Seq Length=71

NGGCATTCCTTAAGCTGACAGCATTCGGGCCGAGATGTCTCTCTAAGTGGACTGAGATGTGATAGCGATAATCTCTATTTCTGGCCTGGAGGCTATCCAGCGTACTCCAAAGATTCAGGTTTACTCACGTCATCCAGCAGAGAATGGA	Seq Length=148

GCTGAGAAAGGGAAGATTGTCATCNNNNNNNATCCCATCACCATCTTCCAGGAGCGAGATCCCTCCAAAATCAAGTGGGGCGATGCTGGCGCTGAGTACGTCGTGGAGTCCACTGGCGTCTTCACCACCATGGAGAAGGCTGGGGCTCATT	Seq Length=151

TTCTGGCTGGAGGCTATCCAGCGTACTCCAAAGATTCAGGTTTACTCACGTCATCCAGCAGAGAATGGA	Seq Length=69

ACATTGACTGAGACACCATGGGGAAGGNNNAGGTCGGAGTCAACGGATTTGGTCGTATTGGGCGCCTGGTCACCAGGGCTGCTTTTAACTCTGGTAAAGTGGATATTGTTGCCATCAATGGCCCCTTCATTGACCTCAACTACATGGTTTA	Seq Length=151

TTTTGGCCTGGAGGCTATCCAGCGTACTCCAAAGATTCAGTTTTACTCACGTCATCCAGCAGAGAATGGA	Seq Length=70

GAAGCATTCGGGCCGAGATGTCTCGCTCCGTGGCCTTAGCTGTGCTCGCGCTACTCTCTCTTTCTGGCCTGGAGGCTATCCAGCGTACTCCAAAGATTCAGGTTTACTCACGTCATCCAGCAGAGAATGGA	Seq Length=131

TTCTGGACTGGAGGCTATCCAGCGTACTAAAAAGATTAAGGTTTACTCACGTCATCCAGCAGAGAATGGA	Seq Length=70

ACTCTAAAGATTCATTTTTACTCACTTCATCCAGAAGAAAAGGGAAGAGAGTAATATCACAAGTATGAACTCAAGAAAAGAGTTTAACAGGTATGCAGTAATATGAAGAAAAAAACAAAAAACAAACCACTAAAAACTATACAACAATAAA	Seq Length=151

GGCTCGAACTAATCTCTCTTTCTGGCCTGGAGGCTATACAGAGTACACCAAAGATTCAGGTTTAGTCACGTCATCCAGAAGAGAATGGAAGATCGGAAGATAACAAGAATGAAATCCAGTCACGGGTCTATCTCGAAAGCCGAATTCTG	Seq Length=149

ATGGCCTGGAGGCTATCCAGCGTACTCCAAAGATTCAGGTTTACTCACGTCATCCAGCAGAGAATGGA	Seq Length=68

CGTTCTGGTCTGGAGGCTATCCAGCGTANTCCAAAGATTCAGGTTTACTCACGTCATCCAGCAGAGAATGGA	Seq Length=72

TTTTGGCCCGGAGGCTATCCAGCGTACTCCAAAGATTCAGGTTTACTCACGTCATCCAGCAGAGAATGGA	Seq Length=70

CTATCTGGGCTGGAGGCTATCCAGCGTACTCCAAAGATTCAGGTTTACTCACGTCATCCAGCAGAGAATGGA	Seq Length=72

ATCTCTGGCCTGGAGGCTATCCAGCGTACTCCAAAGATTCAGGTTTACTCACGTCATCCAGCAGAGAATGGA	Seq Length=72

GATTCCTGGAGCTGACAGCATTCGGGCCGAGATGTCTCTCTCCGTGGCCTTAGCTGTGCTCGCGCTACTCTCTCTTTCTTGCCTTGAGTCTATCCAGCTTACTCCAAAGATTCAGTTTTACTCACGTCATCCANCAGAGANTGTA	Seq Length=145

GACCCTTACTTGTCGGATGGCGTGGANNNGGCGCTGGGGCTGCAGCGTGTCAGCACCCTGCAGGACCTGCTCTTCCACAGCGACTGCGTGACCCTTCACTGCGGCCTCAACGAGCACAACCACCACCTCATCAACGACTTCACCGTCAAG	Seq Length=150

GGGGCATTCCTGAAGCTGACAGCATTCGGGCCGAGATGTCTCGCTCCGTGGCCTTAGCTGTGCTCGCGCTACTCTCTCTTTCTGGCCTGGAGGCTATCCAGCGTACTCCAAAGATTCAGGTTTACTCACGTCATCCAGCAGAGAATGGAAG	Seq Length=151

CCCGCACGCAGTTTTATCCGGTAAAGCGAATGATTAGAGGTCTTGGGGCCGAAACGATCTCAACCTATTCTCAAACTTTAAATGGGTAAGAAGCCCGGCTCGCTGGCGTGGAGCCGGGCGTGGAATGCGAGTGCCTAGTGGGCCACTTTTG	Seq Length=151

GAGGCATTCCTGAAGCTGACAGCATTCGGGCCGAGATGTCTCGCTCCGTGGCCTTAGCTGTGCTCGCGCTACTCTCTCTTTCTGGCCTGGAGGCTATCCAGCGTACTCCAAAGATTCAGGTTTACTCACGTCANCCAGCAGAGAATGGAAG	Seq Length=151

CTCGCTGGGAAGTGGAGCCTTTGGAGAAGTGTATGAAGGAACAGCAGTGGACATCTTAGGAGTTGGAAGTGGAGAAATCAAAGTAGCAGTGAAGACTTTGAAGAAGGGTTCCACAGACCAGGAGAAGATTGAATTCCTG	Seq Length=139

TACCTTACTTGTCGGATGGCGTGGAGNNNNNGCTGGGGCTGCAGCGTGTCAGCACCCTGCAGGACCTGCTCTTCCACAGCGACTGCGTGACCCTGCACTGCGGCCTCAACGAGCACAACCACCACCTCATCAACGACTTCACCGTCAAGCA	Seq Length=151

AAATCCCATCACCATCTTCCAGGAGCGAGATCCCTCCAAAATCAAGTGGGGCNATTCTGGNGCTGATTACNTCGTGGNGTCCACTGGCGTCTTCACCACCATGGANAAGGCTGGGGCTCATTTGCAGGGGGGAGCCAAAAGGGTCATCAT	Seq Length=150

GGGGCATTCCTGAAGCTGACAGCATTCGGGCCGAGATGTCTCGCTCCGTGGCCTTAGCTGTGCTCGCGCTACTCTCTCTTTCTGGCCTGGAGGCTATCCNGCGTACTCCAAAGATTCAGGNTTACTCACGTCATCCAGCAGAGAATGGAAG	Seq Length=151

CTTTACGGCCTGGAGGCTATCCAGCGTNNTCCAAAGATTCAGGTTTACTCACGTCATCCAGCAGAGAATGGA	Seq Length=72

TTCTGGCCTGGAGGCTATCCAGCGTACTCCAAAGATTCAGGTTTACTCACGTCATCCAGCCGAGAATGGA	Seq Length=70

CTCCAAACTCAAGTGGGGCGATGCTGGCGCTGAGTACGTCGTGGAGTCCACTGGCGTCTTCACCACCATGGAGAAGGCTGGGGCTCATTTGCAGGGGGGAGCCAAAAGGGTCATCATCTCCGCCCCCTCTGCTTATGCCCCCATTTTCGT	Seq Length=150

TTCTTGCCCGGAGGCTATCCAGCGTACNNCAAAGATTCAGGTTTACTCACGTCATCCAGCCGAGAATGGA	Seq Length=70

ACTCTGGCCTGGAGGCTATCCAGCGTACTCCAAAGATTCAGGTTTACTCACGTCATCCAGCAGAGAATGGA	Seq Length=71

GGCCTGAAGGCTATCCAGCGTACTCCAAAGATTCAGGTTTACTCACGTCATCCAGCCTAGAATGGCAGATCTGAATAGCACACGTCTAAACTACAGTCACGTGTTTATCTCTTATGCCGTCTTCTGCTTGAAAAAAAAAAAAAAAAATAAT	Seq Length=151

GATTCCTAAAGCTGACAGCATTCGGGCCGAGATGTCTCGCTCCGTGGCCTTAGCTGTGCTCGCGCTACTCTCTCTTTCTGGCCTGGAGGCTATCCAGCGTACTCCAAAGATTCAGGTTTACTCACGTCATCCAGCAGAGAATGGA	Seq Length=145

GGGGCATTCCTGAAGCTGACAGCATTCGGGCCGAGATGTCTCGCTCCGTGGCCTTAGCTGTGCTCGCGCTACTCTCTCTTTCTGGCCTGGAGGCTATCCAGCGTACTCCAAAGATTCAGGTTTACTCACGTCATCCAGCAGAGAATGGAAG	Seq Length=151

TAACAGGTTTACAAAAGAAATCCAGCAGAGAATGGA	Seq Length=36

ACTAGTGAACCTGCACTGCGGCCTCAACGAGCACAACCACCACCTCATCAACGACTTCACCGTCAAGCAGATGAGACAAGGGGCCTACCTGGTGAACACAGCCCG	Seq Length=105

GGCTTCCTGAAGCTGACAGCATTCGGNNNGNGATGTCTCGCTCCGTGGCCTTAGATGTGCTCGCGCAACTCTCTCTTTCTGGCCTGGAGGCTATCCAGCGTACTCCAAAGATTCAGTTTTACTCACGTCAGCCAGCAGAGAATGTA	Seq Length=146

AAAAAAATAAAACAAAACACAACAACAGAAAACCACCAAAAGAAACGATCACAACAGCAAACAAATGGAAAGAAAGAAAAAAACACAAAAAGAGAAAAAAAAACAAAACAAAGAACCAAGAAAGATAGAGAAATAAAGCGATACCACTAAT	Seq Length=151

CTTCCCCCTCTGCTTATTCCCCCATGTTCGTCATGGGTGTGAACCA	Seq Length=46

ACTCCAAAGATTCAGGTTTACTCACNNNNNCNAGCAGAGAATGGA	Seq Length=45

ATAGAAGGAAAGGAGGCAAGAAAGAGAAATAAAAATATAAAGGTTAAAAAACGTCATCCAGCAGAGAATGGAAGAACGGAAGAGCAAAAGTCTGAACACCAGTCACGTGTTTATATCGTATGCCGTCTTCTGCTTGAAAAAAAAAAAAAAA	Seq Length=151

ATGGGAAAAAAGGAAGCAGAAAGAATTAGGGACGATATGTATCGCAAAGTGGCCTTAGCTGTGCTCGCGCTACTAACTCTATCTGGAAAGGAGGCTAACCAGCGTCCTCCAAAGATTCAGGTTTACTCACGTCATCCAGCAGAGAATGGAA	Seq Length=151

CGCCAGGCGAGCCACATCGCTGAGACACCATGGGGAAGGTGAAGGTCGGAGTCAACGGATTTGGTCGTATTGGGCGCCTGGTCACCAGGGCTGCTTTTAACTCTGGTAAAGTGGATATTGTTGCCATCAATGACCCCTTCATTGACCTCAA	Seq Length=151

TGGGCCTGGAGGCTATCCAGCGTACTCCAAAGATTCAGGTTTACTCACGTCATCCAGCAGAGAATGG	Seq Length=67

CTGACTGGCCCGGAGGCTATCCAGCGTACTCCAAAGATTCAGGTTTACTCACGTCATCCAGCAGAGAATGGAAGATAGGAANAGCAAACGTCTGAAATNNAGACAAGAGAGNAGCTCGTNNGCCGTCCTCTGCTTNNAAAAAGGAAAANNA	Seq Length=151

GGGTCATGCCTGAAGCTGACAGCATTCGGGCCTCTATGTCTCGCTCCGTTGCCTTATCTGTTCTCTCTCTACTCTCTCTTTCTGGCCTTTCTGCTATCCAGCGTACTCCAAAGATTCAGGTTTACTCACGTCATCCAGCAGAGAATGGAAG	Seq Length=151

GGCTTGGTGGCTATCCAGCGTACTCCANNTATTCAGGTTTACTCACGTCATCCAGCAGAGAATGGA	Seq Length=66

AGGCATTCCTGAAGCTGACAGCATTCGGGCCGAGATGTCTAGAAAAGAGGACTTAGCTGTGCGCGCGCTACTCTCTAATGATGGCCAGGAGGCTAAAAAGCGTAATCCAAAGATACAGGTTTACTCACGTCATCCAGCCGAGAATGGA	Seq Length=148

CACAACCACCACCTCATCAACGACTTCACCGTCAAGCAGATGAGACAGGGGGCCTTCCTGGTGAACACAGCCCG	Seq Length=74

GGCCTTGAAGCCTAGGTCGCGGGCCCGGGTGTCTCCGCCGCAGTTTCAGCTCTTGGTTTTATTCGCCCCTATTCACACGATAACTTTGCCGTCCGAAGTGAAGAAGGGTTCCAACGACCAGGAGAAGATTGAATTCCTG	Seq Length=139

ATTTCTGGCCTGGAGGCTATCCAGCGTACTCCCCCGATTCAGGTTTACTCACGTCATCCAGCCTATCCTGGACGATCGGACGAGCACACTTCTTAACTCCAGTCACGTGTTTATCTCGTATGCCGTCTTCTGCTTGAAAAAAAAAAAA	Seq Length=148

AGGGCATTCCTGAAGCTGACAGCATTCGGGCCGAGATGTAGAAAAAAGTGGCCTTAGTAGGGATCGCGCTACTCTAAATTACTGGCAGGTAGGCGAGACCGCGAACTCCAAAGCATCAGGTTTACTCACGTCATCCAGCAGAGAATGGCAG	Seq Length=151

TGCTGGGAGGTGGAGCCTTTGGAGAAGTGTATGAAGGAACAGCAGTGGGCATCTTAGGAGTTGGAAGTGGAGAAATCAAAGTAGCAGTGAAGACTTTGAAGAAGGGTTCCACAGACCAGGAGAAGATTGAATTCCTG	Seq Length=137

TTCTGGCCTGGAGGCTATCCAGCGTACTCCAAAGATTCAGGTTTACTCACGTCATCCAGCAGAGAATGGA	Seq Length=70

CGGGACCAACTGACTCTGCGTCTCTTGCTGGGAAGTGGAGCCTTTGGAGAAGTGTATGAAGGAACAGCAGTGGACATCTTAGGAGTTGGAAGTGGAGAAATCAAAGTAGCAGTGAAGACTTTGAAGAAGGGTTCCACAGACCAGGAGA	Seq Length=148

TTGTGGCCTGGAGGCTATCCAGCGTACTCCAAAGATTCAGGTTTACTCACGTCATCCAGCAGAGAATGGA	Seq Length=70

TCCATGGCCTGGAGGCTATCCAGCGTACTCCAAAGATTCAGGTTTACTCACGTCATCCAGCAGAGAATGGA	Seq Length=71

ATACTGGCCTGNAGGCTATCCAGCGTACTCCAAAGATTCAGGTTTACTCACGTCATCCAGCAGAGAATGGG	Seq Length=71

GCGAGCTCCCTCCAAAATCAAGTGGGGCGATGCTGGCGCTGAGTACGTCGTGGAGTCCACTGGCGTCTTCACCACCATGGAGAAGGCTGGGGCTCATTTGCAGGGGGGAGCCAAAAGGGTCATCATCTCTGCCCCCTCTGCTGATGCCCC	Seq Length=150

TTGGATGGCGTGGAGCGGGCGCTGGGGCTGCAGCGTGTCAGCACCCTGCAGGACCTGCTCTTCCACAGCGACTGCGTGACCCTGCACTGCGGCCTCAACGAGCACAACCACCACCTCATCAACGACTTCACCGTNAAGCANATGAGACAAN	Seq Length=151

TTTTGGCCTGGAGGCTATCCAGCGTACTCCAAAGATTCAGGTTTACTCACGTCATCCAGCAGAGAATGGA	Seq Length=70

GAGAACGGGAAGCTTGTCATCAATGGAAATCCCATCACCATCTTCCAGGAGCGAGATCCCTCCAAAATCAAGTGGGGCGATGCTGGCGCTGAGTACGTCGTGGAGTCCACTGGCGTCTTCACCACCATGGAGAAGGCTGGGGCTCATTTG	Seq Length=150

AAAGGGCACCAATCAAACAATAACAAAAACAACGTCACATAAAAAAAACACACCCAAAATTCATACACAGGCCAAAATATACTGAAAAATTCCTCTGANACAATATCAAAACAAAATACNNAAACAAAAAAAAGACAAACATACAAAANCA	Seq Length=151

GTTTCATTCCTTAATCTTACATCATTCTTTCCTAGATGTCTCGCTCCGTGGCCTTATCTGTTCTCTCTCTACTCTCTCTTTNTGGCCTGGAGGCTATCNNGCGTACTCCAANGATTCAGNNTTACTCACGTCATCCAGCAGAGAATGGNAG	Seq Length=151

NGGGCATTCCTGAATCTGACAGCATTCGGGCCTATATATCTCGCTCCGTTTCCTTATCTTTGCTCGCGCTACTCTCTCTTTCTGGCCTGGATGCTATCCAGCGTACTCCAAAGATTCAGGTTTACTCACGTCATCCAGCAGAGAATGGAAG	Seq Length=151

GGTCTGGAGGCTATCCAGCGTACTCCAAAGATTCAGGTTTACCCACGTCATCCAGCAGAGAATGGA	Seq Length=66

TTTGGCCGGAGGCTATCCAGCGTACTNNNAAGATTCAGGTTTACTCACGTCATCCAGCAGAGAATGGA	Seq Length=68

CGGGGGTCGCGTAACTAGTTAGCATGNNNNNGTCTCGTTCGTTATCGGAATTAACCAGACAAATCGCTCCACCAACTAAGAACGGCCATGCACCACCACCCACGGAATCGAGAAAGAGCTATCAATCTGTCAATCCTGTCCGTGTCCGGG	Seq Length=150

CAGTGGGGCGATGCTGGCGCTGAGTACGTCGTGGAGTCCACTGGCGTCTTCACCACCATGGAGAAGGCTGGGGCTCATTTGNNGGGGGGAGCCAAAAGNNTCATCATCTCTNNNCCCTCNNCTGATGNCCNCATGNNNGTCATGGGNNNNA	Seq Length=151

TTTCCTTGGCTGTGCTCGCGCTACTCNNNCTTTCTGGCCTGGAGGCTATCCATCGTACCCCAAAGATTCAGGTTTACTCACGTCATCCAGCAGAGAATGGA	Seq Length=101

CACGTCATCCATCAGAGAATGTAAGATCTTAAGATCACACGTCTTAACTCCAGTCACGTTTTTATCTCGTATGCCGTCTTCTGCTTGAAAAAAAAAAAAAAAATAAAAAGAAAAGAATACTATTATAAAGATTGAAAAAGCAGACGCTAAA	Seq Length=151

TTTCTGAGCCTGGATGCTATCCAGCGTACTCCAAAGATTCAGGTTTACTCACGTCATCCAGCAGAGAATGGA	Seq Length=72

GACGGCCGACTCGACGCTGTGCCACATCCTGAACCTGTACCGGCGGGCCACCTGGCTACACCAGGCGCTGCGGGAGGGCACNCGAGTCCAGAGCGTCGNNCAGATCCGCGANGTGGCGTNNGGCGCTGCCAGGATCNGCGGGGAGACCNTT	Seq Length=151

TGGGCATTCCTGAAGCTGACAGCATTCGGGCCGAGATGTCTCGATACGTGGACTTAGCTGGGATCGAGCAAATATCTATAACTGGCATGGAGGATACACAGCTAACTCCAACTCATCAGGTTTACTACCATCATACCTCAGATAAATTA	Seq Length=149

CTGGCGCTAAGTACGTCGTGGAGTCCACTGGCGTCTTCACCACCATGGAGAAGGCTGGGGCTCATTTGCAGGGGGGAGCCAAAAGGGTCATCATCTCTGCCCCCTCTGCTGATGCCCCCATGTTCGTCATGGGTGTGAACCA	Seq Length=142

CGTCTTGTCGGATGTCGTGGAGCGGGNNNNNGGGCTGCAGCGTGTCAGCACCCTGCAGGACCTGCTCTTCCACAGCGACTGCGTGACCCTGCACTGCGGCCTCAACGAGCACAACCACCACCTCATCAACGACTTCACCGTCAAGCAGATG	Seq Length=151

TTCTGGCCTGGAGGCTATCCAGCGTACTCCAAAGATTCAGGTTTACTCACGTCATCCAGCAGAGAATGGAAGATCGGAAGANCACACGTCTGAACTCCNNACACGTGTTTANCTCGTATNNCGTCTTCTGCTTGAANAAAAAAAAAAANAA	Seq Length=151

AAGCGAATGCGTGACCCTGCACTGCGGCCTCAACGAGCACAACCACCACCTCATCAACGACTTCGCCGTCAAGCAGATGAGACAAGGGGCCTTCCTGGTGAACACAGCCCG	Seq Length=111

TTCTAGCCCGGAGGCTATCCAGCGTACTCCAAAGATTCAGGTTTACTCACGTCATCCAGCAGAGAATGGA	Seq Length=70

GATCATGCCTGGAGGCTATCCAGCGTANTCCAAAGATTCAGGTTTACTCACGTCATCCAGCAGAGAATGGA	Seq Length=71

TTCTGGCCAGGAGGCTATCCAGCGTANNNCAAAGATTCAGGTTTACTCACGTCATCCAGCAGAGAATGGA	Seq Length=70

GGGCATTCCTGAAGCTGACAGCATTCGGGCCGAGATGTCTCGCTCCGTGGCCTTAGCTGTGCTCGCGCTACTCTCTCTTTCTGGCCTGGAGGCTATCCAGCGTACTCCAAAGATTCAGGTTTACTCACGTCATCCAGCAGAGAATGGA	Seq Length=148

TACTGTGCTCGCGCTACTCTCTCTNNNNNNNCTGGAGGCTATCCAGCGTACTCCAAAGATTCAGGTTTACTCACGTCATCCAGCAGAGAATGGA	Seq Length=94

TTCCCATGGAGGCTATCCAGCGTACTCNNAAGATTCAGGTTTACTCACGTCATCCAGCAGAGAATGGA	Seq Length=68

TGCATTCCTGAAGCTGACAGCATTCGGGCCGAGATTTCTCGCCCCGTGGCCTTAGCTGAGCTCGCGCTACACTCTCTTTCTTGCCTTTATGCTACCCAGCTTACTCCACAGATTCAGGTTTACTCACGTCATCCAGCAGAGAATGGA	Seq Length=147

TCTCTGGACTGGAGGCTATCCAGCGTACTCCCCATATTAAGGTTTACTAACTTCATCCCTCCTCGCCTTTCCTATAGGAAGAGCACAAGCCGGCACTCCAGTCAAGTGTTCATATCGTATGCCGTCTTATGCTTGAAAAAAAAAAAGAAAA	Seq Length=151

GGGCATTCCTGAAGCTGACAGCAATCGGGCCGAGATGTCTCGCTCCGTGGCCTTAGCTGTGCTCGCGCTACTCTCTCTTTCTGGCCTGGAGGCTATCCAGCGTACTCCAAAGATTCAGGTTTACTCACGTCATCCAGCAGAGAATGGA	Seq Length=148

GACGACCCTTACTTGTCGGATGGCGTNNNGCGGGAGCTGGGGCTGAAGAGTGTCAGCACCCTGCAGGACCTGCTCTTCCACAGCGACTGCGTGACCCTGCACTGCGGCCTCAATGAGCACAACCACCACCTCATCAACGACTTCACCGTCA	Seq Length=151

TGGGCGATGGGGCTGCAGCGTGTCATCACCCTTCAGGAACTGCTCTTAAACCGCGACTTCTTTCACCTTCCCTGCGGAATCACCGAGAACAAACACAACCTCATAAACGACTTAACCGTCAAGCAGATGAGACAAGGGGCCTTCCTGGTGA	Seq Length=151

CTTCTGGCCTGGAGGCTATCCAGCGTACTCCAAAGATTCAGGTTTACTCACGTCATCCAGCAGAGAATGGA	Seq Length=71

GGGGCATTCCTGAAGCTGACAGCATTCGGGCCTAGATGTCTCGCTCCGTGGCCTTAGCTTTTCTCGCTCTCCTCTCTCTTTCTGGCCTGTCTTCTCTCCAGCGTACTCCAAAGATTCAGGTTTACTCACGTCATCCAGCAGAGAATGGAAG	Seq Length=151

GCTTTCTTGCCTGGAGGCTATCCAGCGTACTCCAAAGATTCAGGTTTACTCACGTCATCCAGCAGAGAATGGA	Seq Length=73

GGTGCCAACAAAGACCCCTTCATTGACCTCACCGACATGGAATAGAAGGGGCTCTATGAAACAAACCCTGGCAAATTCCATGGCACCGTCAAGGAGGAGAACGGGTAGCTTGTCATCCATGGAAATCCCATCACCATCTTCCAGGATCGAT	Seq Length=151

TTTTCTGGCCTGGAGGCTATCCAGCGTNNTCCAAAGATTCAGGTTTACTCACGTCATCCAGCAGAGAATGGA	Seq Length=72

GCGGGCGCTGGGGCCGCAGCGTGTCAGCACCCTGCAGGACCTGCTCTTCCACAGCGACTGCGTGACCCTGCACTGCGGCCTCAACGAGCACAACCACCACCTCATCAACGACTTCACCGTCAAGCAGATGAGACAAGGGGCCTTCCTGGTG	Seq Length=151

CTCTTTCAGGCCTGGAGGCTATCCAGCGTACTCCAAAGATTCAGGTTTACTCACGTCATCCAGCAGAGAATGGA	Seq Length=74

CAAGCTGTGCTCGCGCTACTCTCTCTTTCTGGCCTGGAGGCTATCCAGCGTACTCCAAAGATTCAGGTTTACTCACGTCANNNAGCAGAGAATGGAAGNNCGGAAGAGCACNCNTCTGANNTCCAGTCNCNTGTTNNTCTCGTATGCCNN	Seq Length=150

GCTTTCCTGAAGCTGACATCATTCGGGCCGAGATGTCTCGCTCCGTGGCCTTAGCTGTGCTCGCGCTACTCTCTCTTTCTGGCCTTGAGGCTATCCAGCGTACTCCAAAGATTCAGGATTACTCAAGTCATCCACCAGATAATGGA	Seq Length=146

AAATTGGAATGGAGGCTATCCATCTTACTCCAAAGATTCAGGTTTACTCACGTCATCCAGCAGAGAATGGA	Seq Length=71

CTGCGCTGGCCTGGAGGCTATCCAGCGTACTCCAAAGATTCAGGTTTACTCACGTCATCCAGCAGAGAATGGA	Seq Length=73

GCTGGCCTGGAGGCTATCCAGCGTACTCCAAAGATTCAGGTTTACTCACGTCATCCAGCAGAGAATGGA	Seq Length=69

GGATGCATGAAGATGACAGCATTCTTGCCGTTATGTCTCGCTCCGTGGCCTTCGCTGTGCTCGCGCTACTCTCTCTTGCTGNCCTGGAGGCTATCCAGNNGACTCAAAAGANAAAGGTTNNCTCACGTCATCCAGCNCAGAAAAGAAGNT	Seq Length=150

TTGGGGCGATGCTGGCGCTGAGTACGTCGTGGAGTCCACTGGCGTCTTCACCACCATGGAGAAGGCTGGGGCTCATTTGCAGGGGGGAGCCAAAAGGGTCATCATCTCTGCCCCCTCTGCTGACGCCCCCATGTTCGTCATGGGTGTGAA	Seq Length=150

CTCTGGCCTGGNGGCTATCCAGCGTACTCCAAAGATTCAGGTTTACTCACGTCATCCAGCAGAGAATGGA	Seq Length=70

GGATTCCCAAATAAACCAGGCATTCCCAAATTACTAG	Seq Length=37

GCTTTCCTGAAGCTGACAGCATTCGGGCCGAGATGTCTCGCTCCGTGGCCTTAGCTGTGCTCGCGCTACTCTCTCTTTCTGGCCTGGAGGCTATCCAGCGTACTCCAAAGATTCAGGTTTACTCACGTCATCCAGCAGAGAATGGA	Seq Length=146

ATTTCTGACCTGGAGGCTATCCAGCGTACTCCAAAGATTCAGGTTTACTCACGTCATCCAGCAGAGAATGGA	Seq Length=72

CGCCTTAGCTGTGCTCGCGCTACTCTNNNTTTCTGGCCTGGAGGCTATCCAGCGTACTCCAAAGATTCAGGTTTACTCACGTCATCCAGCAGAGAATGGN	Seq Length=100

TCCGCACATGAACGGGCCCCTGCACCCGCGGCCCCTGGTGGCATTGCTGGATGGCCGGGACTGCACAGTGGAGATGCCCATCCTGAAGGACGTGGCCACTGTGGCCTTGTGCGACGCGCAGTCCACGCAGGAGATCCATGAGAAGGGC	Seq Length=148

TCTCCTCCAAAATCAAGTGGGGCGATGCTGGCGCTGAGTACGTCGTGGAGTCCCCTGTCGTCTTCCCCCCCATGGAGAAGGCTGGGGCTCATTTGCAGGGGGGAGCCAAAAGGGTCATCATCTCTGCCCCCTCTGCTGATGCCCCCATGTT	Seq Length=151

GGACTGGTGGCTATCCAGCGTACTCCAAAGATTCAGGTTTACTCACGTCATCCAGCAGAGAATGGA	Seq Length=66

CGGGACAAACTGACTCTGCGTCTCTTGCTGGGAAGTGGAGCCTTTGGAGAAGTGTATGAAGGAACAGCAGTGGACATCTTAGGAGTTGGAAGTGGAGAAATCAAAGTAGCAGTGAAGACTTTGAAGAAGGGTTCCACAGACCAGGAGA	Seq Length=148

CCATTCTGGCCTGGAGGCTATCCAGCGTACTACAAAGATTCAGGTTTACTCACGTCAACCAGCAGAGAATGGA	Seq Length=73

TGGCCTTAGCTGTGCTCGCGCTACTCTCTCTTTCTGGCCTGGAGGCTATCCAGCGTACTCCAAAGATTCTGTTTTACTCACGTCATCCAGCAGATAATGGA	Seq Length=101

GTTCTGGCTTGGAGGTTATCCAGCGTNNNCCAACGATTTATTTTTCCTCACGTAATCCAGAAGAGAATGGA	Seq Length=71

TTTTATACCATAAACAATTTTCATACTTACTATTATAGTTGGAATATTTCTGGTTGTTACAATCCCACTGACCTTTGTCTGGCATAGAAGATTAGAGAATCAAAAAAGTGCCAAGGAAGGGGTG	Seq Length=124

ATCTCACCATATCTTAATAGCACACGTCTGAACTCCAGTCACGTGTTTATCTCGTATGCCGTCTTCTGCTTGAAAAAAAAAAAAAAAAAAAAAAAAATGTCTACAGACATCACAATATAAAAAAAAACAAAGATGAAAACATATATAAAAA	Seq Length=151

CTTCTGGCCTGGAGGCTATCCAGCGTNNNCCAACGATTTAGTTTTCCTCACGTAATCCAGAAGAGAATGGA	Seq Length=71

CTTCTGTCCTGGAGGCTATCCAGCGTACTCCAAAGATTCCGTTTTACTCACGTCATCCAGCAGCGAATGGA	Seq Length=71

TTTCCTTCTCTCTTAAGCTCCCACGTCCTCACTCCAGTCACGTGTTTCTCTCGTATGCCGTCTTCTGCTTGAAAATAAAAATGTCCTGTAGTCTCTCCCGCTTACTCCCCATCTTCCTGTTTCCTCCCTTCCTCCATCCGCTCATTGCCGA	Seq Length=151

TAGCCTGGAGGCTATCCAGCGTACTCCAAAGATTCAGGTTTACTACCGTCATCAAGCAGAGAATGGA	Seq Length=67

CTAAGCCCTCTGATGATGCAAAAAAGATAGAAATGGGTGTGAACCA	Seq Length=46

CTTTTTTATTATCAAATATTCAAACGNNNNNTTTAGGAGCCTGCGACTTTGGAAGGGAGAGGGTCGAGATAAGGCTCGGACGAGCACACGTCTGGACTCCAGTCACGTGTTTATCTCGTATGCCGTCGTCTGCTTGAAAAAAAAAAAAAAA	Seq Length=151

CGCACTTCGGCCCCAACGAGCACAACCACCACCTCATCCCCGACTTCCCCTAAAAGCAGATGAGCCAAGGGTACTACCTGTTGAACACAGCCCG	Seq Length=94

ATTCTGTCCTGGAGGCTATCCAGCGTACTCCAAAGATTCAGTTTTACTCACGTCATCCATCATAGAATGGA	Seq Length=71

GTTTGGAGATGATGGCGATGAGTACTNNNTGGAGTCCACTGGCGTCGTCACAACCAGGGAGAAGGATGGGGATAATTTGCAGGGGGGAGAAAAAAGGGTCATCATCTCTGCCCCCTCTGCTGACGCCCCCATGTTCGTCATGGGTGTGAA	Seq Length=150

TGAGAAGGAAGAGAACAAGTCTGAACTCCAATAACGTGTTTATATCGTATGACGACAAAAGAAGGAAAAAAAAAACAAAAAACATATAAAAAAATGTAAGATTACATAATAAAAAAAAAAAAAAAACATAAACAAAAAAAACAATCACAT	Seq Length=150

TACGACGCTTACTTGTCGGATGGCGTGGAGCGGGCGCTGGGGCTGCAGCGTTTCATCACCCTGCATTACCTTCTCTTCCACAGCGACTGCTTTACCCTGCACTGCGGCCTCAACGAGCACAACCACCACCTCATCAACGACTTCACCGTCA	Seq Length=151

ATATGGAATGGAGGATATAAAGCGTANNNNAAAGATTCAGGTTTACTCACGTCATCAAGAAGAGAATGGA	Seq Length=70

TTGGCCTGGAGGCTATCCAGCGTACTCNNAAGATTCAGGTTTACTCACGTCATCCAGCAGAGAATGGA	Seq Length=68

AGATTCCTGAAGCTGACAGCATTCGGGCCGAGATGTCTNNCNCCGTNNNCTTAGCTGTGCTCGCGCTACTCTCTCTTTCTNNNCTGGAGGCTATCCAGNNTACTCCAAAGANTNAGGTTNNCTCACGNNANCCATNNNAGAATGGANNNNT	Seq Length=151

CTTTCTGGCCTGGAGGCTATNCAGCGTACTCCAAAGATTCAGGTTTACTCACGTCATCCAGCAGAGAATGGA	Seq Length=72

GTATAAAAGATAGGAAGAGAAAAAGTATGAAATCCAGTCACGTTTTTATCTAGAAAGACTTATTATGATTGAAAACAAAAAAAATAAAAAAAAGATAATATAATTTTAGAATATCAATAAAAAAACAAAAAGAAAAAGAATATAAAATAAA	Seq Length=151

CATCACCGTCTTCCAGGAGCGAGATCCCTCCAAAATCAAGTTGGTCGANGCTGGCGCTTATTACTTCTTTTATTCCACTGNNNTCTTCACTACCATGGNNAAGGCTGGGGCNCNTTTGCNNGGGGGAGNCNAAAGNNTCATCATCTCNNN	Seq Length=150

GACAGTATTCGTGCCGAGATGTCTCGCTCCGTGGCCTTAGCTGTTCTCGCGCTACTCTCTCTTTCTGTCCTGTATGCTATCCAGCGTACTCCAAAGATTCAGGTTTACTCACGTCATCCAGCAGAGAATGGA	Seq Length=132

AAACACCAGACACGTCTTGTAACACGGACCAAGGAGTCTAAAACGTGCGCGAATCGGGAAAAAGAACGAAAGAAGCCGTGGCGCACTGAAAAAGCACGCCGGCGCGCTCGCCGGCCGAGGTGAGATCCCTCCAAAATCAAGTGGGGCGATT	Seq Length=151

ATGCTGGACTGGAGGCTATCCAGCGTACTCCAAAGATTCAGGTGTAATCACGTCATCCAGAAGAGAATGGA	Seq Length=71

GGGGCAAACCTGAAGCTGACAGCATTNNNGCCGAGATGTAAAGGACAGTGGCCTTAGCTGAGATAGCGCAACACACTCTTTCTGGCCTGGAGGCTATCCAGCGTACTCCAAAGATTCAGGTTTACTCACGTCATTCAGCAGAGAATGGAAG	Seq Length=151

TAGCGAGGTGGAGTCCGGCGATGCCAGGATCCGCGGGGAGACATTGGGCATCATCGGACTTGGTCGCGTGGGGCAGGAAGTGNCGCTGCGGGCCAAGGNNTTCGGCTTCACATAGCTCTNNTACGACCCTNACTTNNCGGATGGCGTNNNG	Seq Length=151

GATTCCTGAAGCTGACAGCATTCGGGCCGAGATGTATAGCTCATTGGNCTTAGCTGTGCTCTCGCTACTCTCTCTATCTGGACTGGAGGCTATCCAGAGCACTCAAAAGAGTAAGTTTTACTCAAGTCATCCAGCAGAGAATGGA	Seq Length=145

CACTTAAGGTAGCCAAATGCCTCGTCATCTAACAAGTGACGCGCATGAAAGGATGAACTATATTCCCACTTTCCCTACAAAATATCAAGCGAAACCAAAGAAAAGGGAAAGGGAATGGCGGACAAAGCGTGGAAAAAAGACCAAGTTGAG	Seq Length=150

CTCTCTTTCTGTCCTGGAGGCTATCCAGCGTACTCCAAAGATTCAGGTTTACTCACGTCATCCAGCAGAGAATGGA	Seq Length=76

GGGCATTCGTGAAGCTGACAGCATTCGGGCCGAGATGTCTCGCTCCGTGGCCTTAGCTGTGCTCGCGCTACTCTCTCTTTCTGGCCTGGAGGCTATCCATCTTACTCCAAAGATTCAGGNNCACTCACTTCATCCAGCAGAGAATGGANGA	Seq Length=151

TTCTGGCCTGGAGGCTATCCAGCGTACTCCAAAGATTCAGGTTTACTCACGTCATCCAGCAGAGAATGGA	Seq Length=70

AACTGGCGCCTGCACCCGCGGCCCCTGGTGGCATTGCTGGATGGCCGGGACTGCACAGTGGAGATGCCCATCCTGAAGGACGTGGCCACTGTGGCCTTCTGCGACGCGCAGTCCACGCAGGAGATCCATGAGGAGGTCCTGAACGGGGCNG	Seq Length=151

NTAACTGTCGGATGGCGTGGAGCGGGCGCTGGGGCTGCAGCGTGTCAGCACCCTGCAGGACCTGCTCTTCCACAGCGACTGCGTGACCCTGCACTGCGGCCTCAACGAGCACAACCACCACCTCATCAACGACTTCACCGTCAAGCAGATG	Seq Length=151

CTTGACTGATGGCGTGGAGCGGGCGCTGGGGCTGCAGCGTGTCAGCACCCTGCAGGACCTGCTCTTCCACAGCGACTGCGTGACCCTGCACTGCGGCCTCAACGAGCACAACCACCACCTCATCAACGACTTCNCCGTCAAGCAGATG	Seq Length=148

GACCCCCAAGATCGGAAGAGCACACGNNNGNACTCCAGTCACGTGTTTATCTCGTATGCCGTCTTCTGCTTGAAAAAAAAAAAAAAAAAAAAAAAAAATAAAAAAAATTATTATAAAAAAAAGAGAGAAATAGGATGCATGAAAAAAGACA	Seq Length=151

NTGCCCCCTCTGCTGACGCCCCCATGTTCGTCATGGGTGTGAACCA	Seq Length=46

CTTTTATGGCCTGGAGGCTATCCAGCGTACTCCAAAGATTNAGGTTTNCTCACGTCATCCAGCAGAGAATGGA	Seq Length=73

CAATGACCCCTTCATTGACCTCAACTACATGGTTTACATGTTCCAATATGATTCCACCCATGGCAAATTCCATGGCACCGTCAAGGCTGAGAACGGGAAGCTTGTCATCAATGGAAATCCCATCACGATCTTCCAGGAGCGAGATCCGTC	Seq Length=150

GGCATTCCTGAAGCTGACAGCATTCGGGCCGAGATGTCTCGCTCCGTGGCCTTAGCTGTGCTCGCGCTACTCTCTCTTTCTGGCCTGGAGGCTATCCAGCGTACTCCAAAGATTCAGGTTTACTCACGTCATCCAGCAGAGAATGGA	Seq Length=147

TCAAAATCAAGTGGGGCGATGCTGGCGCTGAGTACGTCGTGGAGTCCACTGGCGTCTTCACCACCATGGAGAAGGCTGGGGCTCATTTGCAGGGGGGAGCCAAAAGGGTCATCATCTCTGCCCCCTCTTCTGACGCCCCCATGTTCGTCAT	Seq Length=151

NTGGCCTGGAGGCTATCCAGCGTACTCCAAAGATTCAGGTTCACTCACGTCATCCAGCAGAGAATGGA	Seq Length=68

TTTTGGCTTGGAGGCTATCCAGCGTACTCCAAAGATTCAGGTTTACTCACGTCATCCAGCAGAGAATGGA	Seq Length=70

CTGATTCAGGTTTACTCACGTCATCCNNNAGAGAATGGA	Seq Length=39

GGGCATACCTGAAGCTGACAGCATTCNNNCCGAGATGTCTCGCTCCGTGGCCTTAGCTGTGCTCGCGCTACTCTCTCTTTCTGGCCTGGAGGCTATCCAGCGTACTCCAAAGATTCAGGTTTACTCACGTCATCCAGCAGAGAATGGA	Seq Length=148

GGCATACCTGAAGCTTACAGCATTCGGGCCGAGATGTCTCGCTCCGTGGCCTTAGCTGTGCTCGCGCTACTCTCTCTTTCTGGCCTGGAGGCTATCCAGCGTACTCCAAAGATTCAGGTTTACTCACGTCATCCAGCAGAGAATGGA	Seq Length=147

ACACTCTCAATCTGGCCTGGAGGCTAAAAATCGTACTCCAAAGATTCAGGTTTACTCACGTCATCCAGCAGAGAATGGA	Seq Length=79

CACAAAAACTAGATCGGAAAATCCCCCTTCTGAACTCCAGTCACGTGTTTATCTCGTATGCCGTCTTCTGCTTGAAAAAAAAAAAAAAAAAAAAAAATAAAACCAAAAGATGAACAATAAAGAGAAGGACAAAAAAGATAGAACAGAA	Seq Length=148

GGGGCATTCCTGAAGCTGACAGCATTCGGGCCGAGATGTCTCGCTCCGTGGCCTTAGCTGTGCTCGCGCTACTCTCTCTTTCTGGCCTGGAGGCTATCCAACGTACTCCAAAGATTCAGGTTTACTCACGTCATCCAGCAGAGAATGGAAG	Seq Length=151

TTTTGGCCTGGAGGCTATCCAGCGTANNNCAAAGATTCAGGTTTACTCACGTCATCCAGCAGAGAATGGA	Seq Length=70

TTGGGTTGCGGCCTCAACGAGCACAANNNCCACCTCATCAACGACTTCACCGTCAAGCAGATTAGACAGGGGGCCTTCCTGGTGAACACAGCCCT	Seq Length=95

AGCTACTACAAAGATTCAGGTTTCCTCACGTCATAAAGAAGAGAATGGAAGATCGGAAGAGCATACGTCTGAACTACAGAAACGTGGTTATAACGTAGGCAGAAAGATGAAGGAACAAAAAAAAAAACACAACAAATACAACAACAAATAA	Seq Length=151

GATGCTGACAGCATTCGGGCCGAGATGTCTCGCTCCGTGGCCTTAGCTGTGCTCGCGCTACTCTCTCTTTCTGGCCTGGAGGCTATCCAGCGTACTCCAAAGATTCAGGTTTACTCACGTCATCCAGCAGAGAATGGA	Seq Length=138

CGGCTGGTGGAAATATTTATGTGTTAAAGGTTCTTGCCTGCCACTCTTAGGAAATTTGGTGTACAGAGAGTCATCCTGTCACTGTTGAAATGTTTAACACACCATAGAAACCTTATTCCTTGTTTCCATATAACACTAGTTTTCAATTTAA	Seq Length=151

ACCTTTCTTGCCTTGAGGCTATCCAGCGTACTCCAAAGATTCAGGTTTACTCACGTCATCCAGCAGAGAATGGA	Seq Length=74

GGGGAAATAATGAATAAGACAGCATTCGGGCAGCTATGTCTCTCACATTTGCCTTAGCTAAGCTAGCGCTACTAGCTCCTTCTGGCCTTGAGGCTATCCATCGTACTCCAAATATTCATGTTTACTCACGTCATCCAGCAGATAATGGAAT	Seq Length=151

CCGTGGCCTTATCTGTGCTCGCTCTACTCTCTCTTTCTGGCCTGGAGGCTATCCAGCGTACTCCAAAGATTCAGGTTTACTCACGTCATCCAGCAGAGAATGGA	Seq Length=104

AATGACAGCGTTCGGGCCGAGATGTCTAGATCCGAGGCCATAGAAGTGAGAGCGCTACAAGAGCTTTCTGGCCTGAAAGAAATCCAAAATACTCAAAATATTCAGTTTTACTCAAGTCATCCAGCCGATAATTGAAGATCTTAATAGCACA	Seq Length=151

TAACTCCAAAGATTCAGGTTTACTCACGTCATCCAGCAGAGAATGGA	Seq Length=47

GNACGTGCCAGAGGCTGTTCACCTTGGAGACCTGCTGCGGAAATGGGTACGGCCCGGCGCGAGATTTACACCCTCTCCCCCGGATTTTCAAGGGCCAGCGAGAGCTCACCGGACGACGCAGGAACCGCGACGCTTTCCAAGGCACGGGCC	Seq Length=150

TTCTGGCCTGGAGGCTATCCAGCGTACTCCAAAGATTCANNNTTACNNACGTCATCCAGCAGAGAATGGA	Seq Length=70

CTTTCTGGCCTGGAGGCTATCCAGCGTACTCCAAAGATTCAGGTTTACTCACGTCATCCAGCAGAGAATGGA	Seq Length=72

GCGTACCCCAAAGATTCAGGTTTACTCACGTCATCCAGCAGAGAATGGA	Seq Length=49

GTTGGCCCTAGCTGTGCTCGCGCTACTCTCTCTTTCTGGCCTGGAGGCTATCCAGCGTACTCCAAAGATTCAGGTTTACTCACGTCATCCAGCAGAGAATGGA	Seq Length=103

CCTTCTTTCCTTTCGGCTCTCCCGCGTCCTCCAAAGATCCCTGTTTCCTCACGTCCTCCAGCAGCGAATGGAAGCTCGGACGCGCACACGTCTGAACACCAGTCACGTGTATATATCGACTGCCGTCCTACGCTATCCAAAAAAAACCCCA	Seq Length=151

AAATGCATAACCATCTTCCAGGAGCGAGATCCCTCCAAAATCAAGTGGGGCGATGCTGGCGCTGAGTACGTCGTGGAGTCCACTGGCGTCTTCACCACAATGGAGAAGGCTGGGAATCATTTGCAGGGGGGAGCCAAAAGGGTCATCAT	Seq Length=149

GTAGCGCTGCGGGCCAAGGCCTTCGGNNNCAACGTGCGCTTCTACGACCCTTACTTGTCGGATGGCGTGGAGCGGGCGCTGGGGCTGAAGCGTGTCAGCACACTGCAGGACCTGCTCTTCCACAGCGACTGCGTGACCCTGCACTGCGGC	Seq Length=150

GCGACTGTGTGACCCTGCACTGCGGCCTCAACGAGCACAACCACCACCTCATCAGCGACTTCACCGTCAAGCAGATGAGACAAGGGGCCTTCCTGGTGAACACAGCCCG	Seq Length=109

GGGCAATCCTGCAGCTGACAGCATTCGGGCCGAGATGTCTCGCTCCGTGGCCTTAGCTGTGATCGCGCTACTCTATCTTTCTGGCCTGGAGGCTATCCAGCGTACTACAAAGATTCAGGTTTACTCACGTCATCCAGAAGAGAATGGA	Seq Length=148

GGGCAATCCTGAAGCTGACAGCATTCGGGCCGAGATGTCTCGATCCGTGGCCTTAGCTGTGCTCGCGCTACTCTCTCTTTCTGGCCTGGAGGCTATCCAGCGTACTCCAAAGATTCAGGTTTACTCACGTCATCCAGCAGAGAATGGA	Seq Length=148

GATTCCTGAAGCTGACAGCATTCGGGCCGAGATGTCTCGCTCCGTGGCCTTAGCTGTGCTCGCGCTACTCTCTCTTTCTGGCCTGGAGGCTATCCAGCGTACTCCAAAGATTCAGGTTTACTCACGTCATCCAGCAGAGAATGGA	Seq Length=145

ATGGCTNCACTCACATCCTTCCTCCTGTACTTACCCCAGCNCAGGTNNCCCCTGCTTTGTGACCATGATGTCCTGTACCCTGCCCTGCGCCCTGTGCTCCTGGCACTGTCTNTGCTGCCCNGGGTCTGTCACTCCGNTCCCCTTGGGCNC	Seq Length=150

CTTCTGACCTGGAGGCTATCCAGCGTACTCCAAAGATTCAGGTTTACTCACGTCATCCAGCAGAGAATGGA	Seq Length=71

CTTCTGGCCTGGAGGCTATCCAGCGTACTCCAAAGATTCAGGTTTACTCACGTCATCCAGCAGAGAATGGA	Seq Length=71

GAGAACGGGAAGCTTGTCATCAATGGAAATCCCATCACCATCTTCCAGGAGCGAGATCCCTCCAAAATCAAGTGGGGCGATGCTGGCGCTGAGTACGTCGTGGAGTCTACTGGCGTCTTCACCACCATGGAGAAGTCTGGGGCTCATTTG	Seq Length=150

GAGAACGGGAAGCTTGTCATCAATGGAAATCCCATCACCATCTTCCAGGAGCGAGATCCCTCCAAAATCAAGTGGGGCGATGCTGGCGCTGAGTACGTCGTGGAGTCTACTGGCGTCTTCACAACCATGGAGAAGGCTGGGGCTCATTTG	Seq Length=150

ACATGGTTTACNTGTTCCAATATGATTCCACCCATGGCAAATTCCATTGCACCGTCAAGGCTGAGAACGGGAAGCTTGTCATCAATGGAAATCCCATCACCATCTTCCAGGAGCGAGATCCCTCCAAAATCAAGTGGGGCGATGCTGGCG	Seq Length=150

TCGCGCTTCTCTCTCTTTCTGGCCTGGAGGCTATCCAGCNTACTCCNAAGATTCAGGTTTACTCACGTCATCCAGCAGAGAATGGAAGATCGGAAGAGCNCACGTCTGAACNCNAGTCANNTGTTTATCTCGTATNNCGTCTTCTGCNNGA	Seq Length=151

TCGCGCTTCTCTCTCTTTCTGGCCTGGAGGCTATCCAGCGTACTCCNAAGATTCAGGTTTACTCACGTCATCCAGCAGAGAATGGA	Seq Length=86

CTTTTAGCCTGNAGGCTATCCAGCGTACTCCAAAGATTCAGGTTTACTCACGTCATCCAGCAGAGAATGGA	Seq Length=71

GCTACTCCAAAGATTCAGGTTTACTCACGTCATCCAGCAGAGAA	Seq Length=44

CTTTTGGCCTGGAGGCTATCCAGCGTACTCCGAAGATTCAGGTTTACTCACGTCATCCAGCAGAGAATGGA	Seq Length=71

CTGCCCCCTCTGCTGACGCCCCCATGNNNGTCATGGGTGTGAACCA	Seq Length=46

GGCCTGGGGGCTATCCAGCGTACTCCAAAGATTCAGGTTTACTCACGTCATCCAGCAGAGAATGGA	Seq Length=66

GATTGATCCTGCCATTAGCATATGCTTGTCTCAAAGATTAAGCCATGCATGTCTAAGTACGCACGGCCGGTACAGTGAAACTGCGAATGGCTCATTAAATCAGTTATGGTTCCTTTNGTCGCTCGCTCCTCCCNTACCTGNNTNACTGTGN	Seq Length=151

GGGCATTCCTGAAGCTGACAGCATTCGGGCCGAGATGTCTCGCTCCGTGGCCTTAGCTGTGCTCGCGCTACTCTCTCTTTCTGGCCTGGAGGCTATCCAGCGTACTCCAAAGATTCAGGTTTACTCATGTCATCCAGCAGAGAATGGAGGA	Seq Length=151

GAAAAGCAGTGGACATCTTAGGAGTTGGAAGTGGAGAAATCAAAGTAGCAGTGAAGACTTTGAAGAAGGGTTCCACAGACCAGGAGAAGATTGAATTCCTG	Seq Length=101

GAAAAGCAGTGGACATCTTAGGAGTTGGAAGTGGAGAAATCAAAGTAGCAGTGAAGACTTTGAAGAAGGGTTCCACAGACCAGGAGAAGATTGAATTCCTG	Seq Length=101

GACAGTCCGCCGCATCTTCTTTTGCGNNNCCAGCCGAGCCACATCGCTGAGGCACCATGGGGAAGGTGAAGGTCGGAGTCAACGGATTTGGTCGTATTGGGCGCCTGGTCACCAGGGCTGCTTTTAACTCTGGTAAAGTGGATATTGTTG	Seq Length=150

GGCCTGGAGGCTATCCAGCGTACTCCAAAGATTCAGGTTTACTCACGTCATCCAGCAGAGAATGGA	Seq Length=66

AGAAGGCAAGGAGGGAAGAGAGAGAAAAAAAACGATTCANGTTTACNNACGTCATCCAGCAGAGAATGGA	Seq Length=70

AAAGGGCAAGGAGGAAAGAGAGAGAAAAAAAACGATTCNNNNTTACNNACGTCATCCAGCAGAGNATGGAAGATCGGAAGNNNACACGTCTGAACTCCNNTCACGTGTTTANANCGTATNNCGTCTTNNGNTTGANNNAAAAAAAANNNNA	Seq Length=151

CTGGCCCGGAGGCTATCCAGCGTACTCCAAAGATTCAGGTTTATTCACGTCATCCAGCAGAGAATGGA	Seq Length=68

TCAAAGNCCTCCGCATCATCGTCCGGATTGGCAGTGGTTNNNACAANNTCGACATCAAGTCGGCCGGGGATTTANACATTGNNGTCTGCAACGTGCCCNNGGCGTCTGTGGNGNAGACGNNCGACTCANAGCTGTNNAACATCCTGNNN	Seq Length=149

GACTGCATTCGGGCCGAGATGTCTCGNNNCGTGGCCTTAGGTGTGCTCGCGCTACTCTCTATTTCTGGCCTGGAGACTATCCAGCGTACTCCAAAGATTAAGGTTTACTCACGTCATCCAGCAGAGAATGGA	Seq Length=132

CTTTTCTGTCCNGGAGGCTATCCAGCGTACTCCAAAGATTCAGGTTTACTCACGTCATCCAGCAGAGAATGGA	Seq Length=73

CTTTCTGGCCTGGAGGCTATCCAGCGTACTCCAAAGATTCAGGTTTACTCACGTCATCCAGCAGAGAATGGA	Seq Length=72

CTTATATGTCGGATGGCGTGGAGCGGGCGCTGGGGCTGCAGCGTGTCAGCACCCTGCAGGACCTGCTCTTCCACAGCGACTGCGTGACCCTGCACTGCGGCCTCAACGAGCACAACCACAACCTCATCAACGACTTCACCGTCAAGC	Seq Length=147

GCATTCCTGAAGCTGACAGCATTCGGGCCGAGATGTCTCGCTCCGTGGCCTTAGCTATGCTCGCGCTACTCTCTCTTTCTGGCCTGGAGGCTATCCAGCGTACTCCAAAGATTCAGGTTTACTCACGTCATCCAGCAGAGAATGGA	Seq Length=146

CCTACGACCCTTACTTGTCGGATGGCGTGGAGCGGGCGCTGGGGCTGCAGCGTGTCAGCACCCTGCAGGACCTGCTCTTCCACAGCGACTGCGTGACCCTGCACTGCGGCCTCAACGAGCACAACCACCACCTCATCAACGACTTCACCGT	Seq Length=151

CGTCAAGGCTGAGAACGGGAAGCTTGTCATCAATGGAAATCCCATCACCATCTTCCAGGAGCGAGATCCCTCCAAAATCAAGTGGGGCGATGCTGGCGCTGAGTACGTCGTGGAGTCCACTGGCGTCTTCACCACCATGGAGAAGGCTGGG	Seq Length=151

NTCTGCCCCCTCTGCTGATGCCCCCATNNTCGTCATGGGTGTGAACCA	Seq Length=48

GCGCCAAAGATTCAGGTTTACTCACGTCATCCAGCAGAGAATGGA	Seq Length=45

GAGGGCCCGAAGACATCCAGGATCCACNNTGCGACGAGCTGTGCCGCACGGTGAT	Seq Length=55

GCAATGCGGCCTCAACGAGCACAACCACCACCTCATCAACGACTTCACCGTCAAGCAGATGAGACAAGGGGCCTTCCTGGTGAACACAGCCCG	Seq Length=93

GCAATGCGGCCTCAACGAGCACAACCACCACCTCATCAACGACTTCACCGTCAAGCAGATGAGACAAGGGGCCTTCCTGGTGAACACAGCCCG	Seq Length=93

GGGGCATTCCTGAAGCTGACAGCATTCGGGCCGAGATGTCTCGCTCCGTGGCNTTAGCTGTGCTCGCGCTACTCTCTCTTTCTGGCCTGGAGGCTATCCAGCGTACTCCAAAGATTCAGGTTTACTCACGTCATCCAGCAGAGAATGGAAG	Seq Length=151

TCTGGCTGGAGGCTATCCAGCGTACTCNNAAGATTAAGGTTTACTCACGTCATCCAGCAGAGAATGGA	Seq Length=68

TTCAGGTTTACTCACGTCATCCAGCANNNAATGGA	Seq Length=35

GGGGCATCCCTGAAGCCGACAGCATTCGGGCCGAGATGTCTCGCTCCGTGGCCTTAGCTGTGCTCGCGCTACTCTCTCTTTCTGGCCTGGAGGCTATCCAGCGTACTCCAAAGATTCAGGTTTACTCACGTCATCCAGCAGAGAATGGAAG	Seq Length=151

GGGGCATCCCTGAAGCCGACAGCATTCGGGCCGAGATGTCTCGCTCCGTGGCCTTAGCTGTGCTCGCGCTACTCTCTCTTTCTGGCCTGGAGGCTATCCAGCGTACTCCAAAGATTCAGGTTTACTCACGTCATCCAGCAGAGAATGGAAG	Seq Length=151

TTCTGGCCTGGAGGCTATCCAGCGTACTCCAAAGATTCAGGTTTACTCACGTCATCCAGCAGAGAATGGA	Seq Length=70

TGCGTGGCCTTAGCTGTGCTCGCGCTACTCTCTCTTTCTGGCCTGGAGGCTATCCAGCGTACTCCAAAGATTCAGGTTTACTCACGTCATCCAGCAGAGAATGGA	Seq Length=105

CCCTGCCTGCGGCCTCAACGAGCACAACCACCACCTCATCAACGACTTCACCGTCAAGCATATGAGACAAGGGGCCTTCCTGGTGAACACAGCCCG	Seq Length=96

AAAAGTAAAGGGGAGAAGCGGAAGAGNNNAAAGACGTGGAAAAAAGTGGAGTATTAACCACAATAGGAAAGGATGGGGAACATTTGAAGGGGGGAGCCAAGAGGAGAATCATCTAAGAAACCAATGAAAAGGCCAACATGTAAGACATGGG	Seq Length=151

GGGGCATTCCTGAAGCTGACAGCATTNNNGCCGAGATGTCTCGCTCCGTGGCCTTAGCTGTGCTCGCGCTACTCTCTCTTTCTGGCCTGGAGGCTATCCAGCGTACTCCAAAGATTCAGGTTTACTCACGTCATCCAGCAGAGAATGGAAG	Seq Length=151

GGGGCATTCCTGAAGCTGACAGCATTCNGGCCGAGATGTCTCGCTCGGTGGCCTTAGCTGTGCTCGCGCTACTCTCTCTTTCTGGCCTGGAGGCTATCCAGCGTACTCCAAAGATTCAGGTTTACTCACGTCATCCAGCAGAGAATGGAAG	Seq Length=151

CAGGCTGAGGATCATTTGCAGGGGGGANCCAAAAGGGTCATCATCTCTGCCCCCTCTGCTGACGCCCCCATGTTCGTCATGGGTGTGAACCA	Seq Length=92

CTTGGTCGGATGGCGTGGAGCGGGCGCTGGGGCTGCAGCGTTTCAGCACCCTGCAGGACCTGCTCTTCCACAGCGACTGCGTGACCCTGCACTGCGGCCTCAACGAGCACAACCACCACCTCATCAACGACTTCACCGTCAAGCAGATGAG	Seq Length=151

CCGATTGTGAACGGGCCCCTGCACCCGCGGCCCCTGGTGGCATTGCTGGATGGCCGGGACTGCACAGTGGAGATGCCCATCCTGAAGGACGTGGCCACTGTGGCCTTCTGCGACGCGCAGTCCACGCAGGAGATCCATGAGAAGGTCCTGA	Seq Length=151

TTCTGGGTTGGAGGCTATCCAGCGTACTCCAAAGATTCATGTTTACTCACGTCATCCAGCAGAGAATGGA	Seq Length=70

GGGTATTCCTGAAGCTGACAGCATTCNNNCCGAGATGTCTCTCTCCGTGGCCTTAGCTGTGCTCGCGCTACTCTCTCTTTCTGGCCTGGAGGCTATCCAGCGTACTCCAAAGATTCAGGTTTACTCACGTCATCCAGCAGAGAATGGA	Seq Length=148

GGCTGCACCAGGCGCTGCGGGAGGGCNNNCGAGTCCAGAGCGTCGAGCAGATCCGCGAGGTGGCGTCCGGCGCTGCCAGGATCCGCGGGGAGACCTTGGGCATCATCGGACTTGGTCGCGTGGGGCAGGCAGTGGCGCTGCGGGCCAAGG	Seq Length=150

CCGCTGATGCCCCCATGTTCGTCATGGGTGTGAACCA	Seq Length=37

GCACCATCTTCCAGGAGCGAGATCCCTCCAAAATCAAGTGGGGCGATGCTGGCGCTGAGTACGTCGTGGAGTCCACTGGCNNCTTCACCACCATGGAGNNGGCTGGGGCTNNTNTGCANNNGGGAGCNNANAGGGNNNTCATCTCTNNNN	Seq Length=150

GTTTTGGCCTGGAGGCTATCCAGCGTACTCCAAAGATTCAGGTTTACTCACGTCATCCAGCAGAGAATGGA	Seq Length=71

CTTTCTGGCCTGGAGGCTATCCAGCGTNNTCCAAAGATTCAGGTTTACTCACGTCATCCAGCAGAGAATGGA	Seq Length=72

GCAGACCCTGCACTGCGGCCTCAACGANCACAACCACCACCTCATCAACGACTTCACCGTCAAGCAGATGAGACAAGGGGCCTTCCTGGTGAACACAGCCCG	Seq Length=102

TTAGGCTGAGAACGGGAAGCTTGTCATCAATGGAAATCCCATCACCATCTTCCAGGAGCGAGATCCCTCCAAAATCAAGTGGGGCGATGCTGGCGCTGNNAACGTCGTGGANTNCACTNNNGTCTTCACCACCATNNAGAAGGCTGGNN	Seq Length=149

TTTTGGCCCGGAGGCTATCCAGCGTACTCCAAAGATTCAGGTTTACTCACGTCATCCAGCAGAGAATGGA	Seq Length=70

CTTCTGGCCTGGAGGCTATCCGGCGTACTCCAAAGATTCAGGTTTACTCACGTCATCCAGCAGAGAATGGA	Seq Length=71

CCGTAGCCAAANGCCTCGTCATCTAATTAGTGACGCGCATGAATGGATGAACGAGATTCCCACTGTCCCTACCTACTATCCAGCGAAACCACAGCCAAGGGAACGGGCTTGGCGGAATCAGCGGGAAAAGAAGACCCTGTTGAGCTTGA	Seq Length=149

GGTTCCTGAAGCTGACAGCATTCGGGCCGAGATGTCTCGCTCCGTGGCCTTAGCTGTGCTCGCGCTACTCTCTCTTTCTGGCCTGGAGGCTATCCAGCGTACTCCAAAGATTCAGGTTTACTCACGTCATCCAGCAGAGAATGGA	Seq Length=145

GATGCTGACAGCATTCGGGCCGAGATNNNNCGCTCCGTGGCCTTAGCTGTGCTCGCGCTACTCTCTCTTTCTGGCCTGGAGGCTATCCAGCGTACTCCAAAGATTCAGGTTTACTCACGTCATCCAGCAGAGAATGGA	Seq Length=138

TAGTTTGTCGGATGGCGTGGAGCGGGCGCTGGGGCTGCAGCGGGTCAGCACCCTGCAGGACCTGCTCTTCCACAGCGACTGCGTGACCCTGCACTACGGCCTCAACGAGCANAACCACCANCTCATCAACGACTTCNCCGTCAAGCAANAA	Seq Length=151

TAGTTTGTCGGATGGCGTGGAGCGGGCGCTGGGGCTGCAGCGTGTCAGCACCCTGCAGGACCTGCTCTTCCACAGCGACTGCGTGACCCTGCACTGCGNNCTCAACGAGCANANCCACNNNCTCATCAACGACTTNNCCGTCAAGCANNTG	Seq Length=151

GGCCTAGAGGCTATCCAGCGTACTCCAAAGATTCAGGTTTACTCACGTCATCCAGCAGAGAATGGA	Seq Length=66

TGGTCATCTTAGGAGTTGGAAGTGGAGAAATCAAAGTAGCAGTGAAGACTTTGAAGAAGGGTTCCACAGACCAGGAGAAGATTGAATTCCTG	Seq Length=92

CGCCCGCTCTGCTGACGCCCCCATGTTCATCATGGGTGTGAACCA	Seq Length=45

TTCTGGCCTGGAGGCTATCCAGCGTACTCCAAAGATTCAGGTTTACTCACGTCATCCAGCAGAGAATGGA	Seq Length=70

GTCTAGGCCTGGAGGCTATCCAGCGTACTCCAAAGATTCAGGTTTACTCACGTCATCCAGCAGAGAATGGA	Seq Length=71

GTCCGGCTCCANTAGCGTATATTAAAGTTGCTGCAGTTAAAAAGCTCGTAGTTGGATCTCGGGGACGGGCGGTGGCTCGCCTCGCGGCGGACCGCCCGTCCCCGCCCCTTGCCTCTCGGCGCCCCCTCGATGCTCTTAGCTGAGTGTCCCG	Seq Length=151

CTCATCATCTCTGCCCCCTCTGCTGANNNCCCCATGTTCGTCATGGGTGTGAACCA	Seq Length=56

GGGGCATTGCTGAAGCTGACCGCATTCGGGCCGAGATGTCTCGCTCCGTGGCCTTAGCTGTGCTCGCGCTACTCTCTCTTTCTGGCCTGGAGGCTATCCAGCGTACTCCAAAGATTCAGGTTTACTCACGTCATCCAGCAGAGAATGGAAA	Seq Length=151

GNGCATTCCTGAAGCTGACAGCATTCGGGCCGAGATGTCTCGCTCCGTGGCCTTAGCTGTGCTCGCGCTACTCTCTCTTTCTGGCCTGGAGGCTATCCAGCGTACTCCAAAGATTCAGGTTTACTCACGTCATCCAGCAGAGAATGGA	Seq Length=148

GGGGCATTCCTGAAGCTGACAGCATTCNGGCCGAGATGTCTCGCTCCGTGGCCTTAGCTGTGCTCGCGCTACTCTCTCTTTCTGGCCTGGAGGCTATCCAGCGTACTCCAAAGATTCAGGTTTACTCACGTCATCCAGCAGAGAATGGAAG	Seq Length=151

CGAATTTAAATGGGAAAGAAGCCCGGCTCGCTGGCGTGGGGCCGGGCTTCTTACCCATTTAAAGTTTGAGAATAGGTTGAGATCGTTTCGGCCCCAAGACCTCTAATCACTCGCTTTANNAGATAAAAAAGCGAGGAGATCGGAAGAANA	Seq Length=150

GGGGCATTCCTGAAGCTGACAGCATTNNNGCCGAGATGTCTCGCTCCGTGGCCTTAGCTGTGCTCGCGCTACTCTCTCTTTCTGGCCTGGAGGCTATCCAGCGTACTCCAAAGATTCAGGTTTACTCACGTCATCCAGCAGAGAATGGAAG	Seq Length=151

GGGGCATTCCTGAAGCTGACAGCATTNNNGCCGAGATGTCTCGCTCCGTGGCCTTAGCTGTGCTCGCGCTACTCTCTCTTTCTGGCCTGGAGGCTATCCAGCGTACTCCAAAGATTCAGGTTTACTCACGTCATCCAGCAGAGAATGGAAG	Seq Length=151

ATTTCTGGAATGGAGGCTATACAGCGNNNTCCAAAGATTCAGGTTTACTCACGTCATCCAGCAGAGAATGGA	Seq Length=72

GGTTTTCTAACGTCATCCAGAAGAGAATGGA	Seq Length=31

TGGCAGTGGTTTTGACAACATCGACATCAAGTCGGCCGGGGATTTAGGCATTGCCGTCTGCAACGTGCCCGCGGCGTCTGTGGAGGAGACGGCCGACTCGACGCTGTGCCACATCCTGAACCTGTACCGGCGGNNCACCTGGCTGCACCAG	Seq Length=151

TGGCAGTGGTTTTGACAACATCGACATCAAGTCGGCCGGGGATTTAGGCATTGCCGTCTGCAACGTGCCCGCGGCGTCTGTGGAGGAGACGGCCGACTCGACGCTGTGCCACATCCTGAACCTGTACCGGCGNGNCACCTNGCTGCACCAN	Seq Length=151

GGGGCATTCCTGAAGCTGACAGCATTCGGGCCGAGATGTCTCGCTCCGTGGCCTTAGCTGTGCTCGCGCTACTCTCTCTTTCTGGCCTGGAGGCTATCCAGCGTACTCCAAAGATTCAGGTTTACTCACGTCATCCAGCAGAGAATGGAAA	Seq Length=151

GCTATTTCTGGCCTGGAGGCTATCCAGCGTACTCCAAAGATTCAGGTTTACTCACGTCATCCAGCAGAGAATGGA	Seq Length=75

TTCTTGACGGAGGCTATCCAGCGTACTCCAAAGATTCAGGTTTACTCACGACATCCAGCAGAGAATGGA	Seq Length=69

GGGCTGGCGGCTATCCAGCGTACTCCGAAGATTCAGGTTTACTCACGTCATCCAGCAGAGAATGGA	Seq Length=66

CNTAACTTTAAATGGGTAAGAAGCCCGGCTCGCTGGCGTGGAGCCGGGCGAGGAATGCGAGTGCCTAGTGGGCCAATTTTGGTGGATGAGAAGGCGC	Seq Length=97

TCGGCTGGCGACGCAAAAGAAGATGCGGCTGACTGTCGAACAGGAGGAGCAGAGAGCCCATGGGGAAGGTGAAGGTCGGAGTCAACGGATTTGGTCGTATTGGGCGCCTGGTCACCAGGGCTGCTTTTGACTCTGGTAAAGTGGATATTGT	Seq Length=151

TCGGCTGGCGACGCAAAAGAAGATGCGGCTGACTGTCGAACAGGAGGAGCAGAGAGCCCATGGGGAAGGTGAAGGTCGGAGTCAACGGATTTGGTCGTATTGGGCGCCTGGCCACCAGGGCTGCTTTTGACTCTGGTAAAGTGGATATTGT	Seq Length=151

TCTGGCTGGAGGCTATCCAGCGTACTCNNAAGATTCAGGTTTACTCACGTCATCCAGCAGAGAATGGA	Seq Length=68

TTGTTGGCCTGGGGGCTATCCAGCGTACTCCAAAGATTCAGGTTTACTCACGTCATCCAGCAGAGAATGGA	Seq Length=71

TCTCTTTCTGGCCTGGAGGCTATCCAGCGTACTCCAAAGNTTCAGGNTTACTCACGTCATCCAGCAGAGAATGGA	Seq Length=75

TTCAGGCCTGGAGGCTATCCAGCGTACTCCAAAGATTCAGGTTTACTCACGTCATCCAGCAGAGAATGGA	Seq Length=70

TAATTGTCGGATGGCGTGGAGCGGGCGCTGGGGCTGCAGCGTGTCAGCACCCTGCAGGACCTGCTCTTCCACAGCGACTGCGTGACCCTGCACTGCGGCCTCAACGAGCACAACCACCACCTCATCAACGACTTCACCGTCAAGCAGATGA	Seq Length=151

TTCTGGCCTGGAGGCTATCCNGCGTANNNCAAAGATTCAGGTTTACTCACGTCATCCAGCAGAGAATGGA	Seq Length=70

GGTCTGAGGCTATCCAGCGTACTCCAAAGATTCAGGTTTACTCACGNCATCCAGCAGAGAATGGA	Seq Length=65

TTCTGGCCTGGAGGCTATCCAGCGTACTCCAAAGATTCAGGTTTACTCACGTCATCCAGCAGAGAATGGA	Seq Length=70

CAAACTCAAAATGGGTAAGAAGCCCGGCTCGCTGGCGTGGAGCCGGGCGTGGAGTGCGAGTGCCTAGTGGGCCACTTTTGGTAAGCAGAACTGGCGCTGCGGGATGAACCGAACGCCGGGTTAAGGCGCCCGATGCCGACGCTCATC	Seq Length=147

GGGGCATTCCTGAAGCTGACAGCATTCGGGCCGAGATGTNTCGCTCNGTGGCCTTAGCTGTGCTCGCGCCACTCTCTCTTTCTGGCCTGGAGGCTATCCAGCGTACTCCAANGATTCAGGNTTACTCACGTCATCNNGCAGAGAATGGNAG	Seq Length=151

CTTTTCGGCCTGGAGGCTATCCAGCGTACTCCAAAGATTCAGGTTTACTCACGTCATCCAGCAGAGAATGGA	Seq Length=72

CTTGCTNGGAAGTGGAGCCTTTGGAGAAGTGTATGAAGGNNCAGCANNGGACATCTTAGGAGTTGGAAGTGGAGNAATCAANGTAGCAGTGAAGACTTNNAAGAAGGGTTCNANAGACNNNGAGAAGATTGAATTNNTGAGATCGGANNAG	Seq Length=151

CCAGGTTTACTCACGTCATCCAGCAGAGAATGGA	Seq Length=34

ATTTAGCTGTGCTCGCGCTACTCTCTCTTTCTGGCCTGGAGGCTATCCAGCGTACTCCAAAGACTCAGGTTTACTCACGTCATCCAGCAGAGAATGGA	Seq Length=98

CCGTGGNCTTAGCTGTGCTCGCGCTACTCTCTCTTTCTGGNCTGGANGCTATCCAGCGTACTCCAAAGATTCAGGTTTACTCACGTCATCCAGCAGAGAATGGA	Seq Length=104

TTCTGGCCTGGAGGCTATCCAGCGTACTCCAAAGATTCAGGTTTACTCACGTCATCCAGCAGAGAATGGA	Seq Length=70

TGGCATCAATGGAAATCCCATCACCATNNTCCAGGAGCGAGATCCCTCCAAAATCAAGTGGGGCGATGCTGGCGCTGAGTACGTCGTGGAGTCCACTGGCGTCTTCACCACCATGGAGAAGGCTGGGGCTCATTTGCAGGGGGGAGCCAAA	Seq Length=151

TAGCTGTTCTCGCGCTACTCTCTCTTTCTGGCCTGGAGGCTATCCAGCGTACTCCAAAGATTCAGGTTTACTCACGTCATCCAGCGGAGAATGGA	Seq Length=95

GGCTGCCGCAGCTAGGAATAATGGAATAGGACCGCGGTTCTATTTTGTTGGTTTTCGGAACTGAGGCCATGATTAAGAGAGACGGCTGGAGTGTGAGGAAGGGAGAGAGTCGAGATCC	Seq Length=118

CTAGGCAAGCCCAGGCCCAGCTGCTTGTAACAGTGGAGGGGTCATATGTGGCCGAGGAGGCGGGCTGCCCCCTGTCCTGTGCAGTCAGCAAAG	Seq Length=93

TACCTGGCCTGGAGGCTATCCAGCGTACTCCAAAGATTCAGGTTTACTCACGTCATCCAGCAGAGAATGGA	Seq Length=71

GGGTCTGCTTTTAACTCTGGTAAAGTGGATATTGTTGCCATCAATGAACCCTTCAGTGACCTAAACTACATTGTTTACATGTTCCAATATGATTCCACCCATGGCAAATTCCATGGCACCGTAAAGGCTGAGAACGGGAAGCTTGTCATCA	Seq Length=151

TTTTGCCTGGAGGCTATCCAGCGTACTCCAAAGCTACATGTCACCTCACTTGATCCAGCCTCGAATGAACGATCGTCAACGAAGAATTATGAACTCCAGTAACTTGATAAGAAGGGATAAAGAAGAGGGAAGGAAAAAAAAAAAGGAGGAA	Seq Length=151

TTTGGCCTGGAGGCTATCCAGCGTACTCCAAAGCTTCATTATACCTCCCTTCCTCCAGCCTCTAATGCACTATCGTCAGCGCACACTTCTGAACTCCAGTCACTTGTTGATAGCGTAAGACGTATTATGCATGAAAAAAAAAAAAAAAAAA	Seq Length=151

ATCAAGTGGGGCGATGCTGGCGCTGAGTACGTCGTGGAGTCCACTGGCGTCTTCACCACCATGGAGAAGGCTGGGGCTCATTTGCAGGGGGGAGCCAAAAGGGTCATCATCTCTGCCCCCTCTGCTGACGCCCCCATGTTCGTCATGGGTG	Seq Length=151

CTTTTTGGCCTGGAGGCTATCCAGCGTACTCCAAAGATTCAGGTTTACTCACGTCATCCAGCAGAGAATGGA	Seq Length=72

TGGGCATTCCTGAAGCTGACAGCATTCGGGCCGAGATGTCTCGCTCCGTGGCCTTAGCTGTGCTCGCGCTACTCTCTCTTTCTGGCCTGGAGGCTATCCAGCGTACTCCAAAGATTCAGGTTTACTCACGTCATCCAGCAGAGAATGGAAG	Seq Length=151

GATTCCTGCAGCTGACAGCATTCGGGCCGAGATGTCTCGCTCCGTGGCCTTGGCTGTGCTCGCGCTACTCTCTCTTTCTGGCCTGGAGGCTATCCAGCGTACTCCAAAGATTCAGGTTTACTCACGTCATCCAGCAGAGAATGGA	Seq Length=145

CNATATCAAGTGGGGCGATGCTGGCGCTGAGTACGTCGTGGAGTCCACTGGCGTCTTCACCACCATGGAGAAGGCTGGGGCTCATTTGCAGGGGGGAGCCAAAAGGGTCATCATCTCTGACCCCTCTGCTGATGCCCCCATGTTCGTCATG	Seq Length=151

TCCACTTGCCGGATGGCGTGGAGCGGGCGCTGGGGCTGCAGCGTGTCAGCACCCTGCAGGGCCTGCTCTTCCACAGCGACTGCGTGACCCTGCACTGCGGCCTCAACGAGCACAACCACCACCTCATCAACGACTTCACCGTCAAGC	Seq Length=147

CATTGGGGCGATGCTGGCGCTGAGTACGTCGTGGAGTCCACTGGCGTCTTCACCACCATGGAGAAGGCTGGGGCTCATTTGCAGGGGGGAGCCAAAAAGGGTCATCATCTCTGCCCCCTCTGCTGACGCCCCCANGTTCGTCATGGGTGTG	Seq Length=151

CATTGGGGCGATGCTGGCGCTGAGTACGTCGTGGAGTCCACTGGCGTCTTCACCACCATGGAGAAGGCTGGGGCTCATTTGCAGGGGGGAGCCAAAAAGGGTCATCATCTCTGCCCCCTCTGCTGACGCCCCCANGTTCGTCATGGGTNTG	Seq Length=151

GGGGCATTCCTGAAGCTGACAGCATTCGGGCCGAGATGTCTCGCTCCGTGGCCTTAGCTGTGCTCGCGCTACTCTCTCTTTCTGGCCTGGAGGCTATCCAGCGTACTCCAAAGATTCAGGTTTACTCACGTCATCCAGCAGAGAATGGAAG	Seq Length=151

GCATTCCTGAAGCTGACAGCATTCGGGCCGAGATGTCTCGCTCCGTGGCCTTAGCTGTGCTCGCGCTACTCTCTCTTTCTGGCCTGGAGGCTATCCAGCGTACTCCAAAGATTCAGGTTTACTCACGTCATCCAGCAGAGAATGGA	Seq Length=146

TTGGGTTGCGCTACAGAAGTGGAAATACAATGAGTTTTACCATGTTAAAACTTCATGCAGCC	Seq Length=62

ACTTGTCTGATGGCGTGGAGCGGGCGCTGGGGCTGCAGCGTGTCAGCACCCTGCAGGACCTGCTCTTCCACAGCGACTGCGTGACCCTGCACTGCGGCCTCAACGAGCACAACCACCACCTCATCAACGACTTCACCGTCAAGCAGATGAG	Seq Length=151

GCTTTGGCCTGGAGGCTATCCAGCGTACTCCAAAGATTCAGGTTTACTCACGTCATCCAGCAGAGAATGGA	Seq Length=71

GTGTACTCCAAAGATTCAGGTTTACTCACGTCATCCAGCAGGGAATGGA	Seq Length=49

AAAAGGGAAGACTAGGAGAAAAAGAAGAAGAGGAGGGAGAACAAAGAGAGGAGAAGAAAAAGAGAAGCAAAAAAAGAAGAAGAGTAAAGATAAAATAGAAAAAACAAAAAAGAAGAAAAAACGAGAAATAGGAAAAGGTAAGAGAAAAGTA	Seq Length=151

TCATCTGCAGGGGGGAGCCAAAAGGGTCATCATCTCTGCCCCCTCTGCTGATGCCCCCATGTTCGTCATGGGAGTGAACCA	Seq Length=81

GATTCCTGAAGCTGACAGCATTCGGGCCGAGATGTCTCGCTCCGTGGCCTTAGCTGTGCTCGCGCTACTCTCTCTTTCTGGCCTGGAGGCTATCCAGCGTACTCCAAAGATTCAGGTTTACTCACGTCATCCAGNAGAGAATGGA	Seq Length=145

GGATTTGGTCGTATTGGGCGCCTGGTCACCAGGGCTGCTTTTAACTCTGGTAAAGTGGATATTGTTGCCATCAATGACCCCTTCATTGACCTCAACTACATGGTTTACATGTTCCAATATGATTCCACCCATAGNAAATTCCATGGCACCG	Seq Length=151

TTCCAGGCCTGGAGGCTATCCAGCGTANNCCAAAGATTCAGGTTTACTCACGTCATCCAGCAGAGAATGGA	Seq Length=71

CGGTTTGAGGGACAGGGATGTAGGGCAGGGGAGTGGGAAAGTGAGGTTTTTCTAAAGGCTTCAGGTTATTAGAGGTAGTAGGTAAATGTCATGGTAGTAGAGTATCTTGGTAGGTCACATAGTTTTTATTTATCTTGTTTTCTTGTGTAAT	Seq Length=151

TGGGCATTCCTGAAGCTGACAGCATTCGGGCCGAGATGTCTCGCTCCGTGGCCTTAGCTGTGCTCGCGCTACTCTCTCTTTCTGGCCTGGAGGCTATCCAGCGTACTCCAAAGATTCAGGTTTACTCACGTCATCCAGCAGAGAATGGAAG	Seq Length=151

GATTCCTGAAGCTGACAGCATTCGGGCCGAGATGTCTCGCTCCGTGGCCTTAGCTGTGTTCGCGCTACTCTCTCTTTCTGGCCTGGAGGCTATCCAGCGTACTCCAAAGATTCAGGTTTACTCACGTCATCCAGCAGAGAATGGA	Seq Length=145

CAGCCCTCCAGCCGTCTCTTCACCGTGCCAGACTAGAGTCAAGCTCAACAGGGTCTTCTTTCCCCGCTGATTCCGCCAAGCCCGTTCCCTTGGCTGTGGTTTCGCTGGATAGTAGGTAGGGACAGTGGGAATCTCGTTCATCCATTCATG	Seq Length=150

CGCTCCGTGGCCTTAGCTGTGCTCGCGCTACTCTCTCTTTCTGGCCTGGAGGCTATCCAGCGTACTCCAAAGATTCAGGTTTACTCACGTCATCCAGCAGAGAATGGA	Seq Length=108

AAAAGAGAAAATAGAGAGGAGGAAAAGGAGGAAGAGAAGTGAGAAGGAGAAAGAGAAGGGAAGAAAAGAGTGAAGGAAGGAAGAAGAAAGGTGAAAACATAAAGAAAGAGAAGTGCAGAGAAAAAGAAGAAAAAATTAAAAAAGAGAGCAA	Seq Length=151

NTGACTGGCCTGGAGGCTATCCAGCGTACTCCAAAGATTCAGGTTTACTCACGTCATCCAGCAGAGAATGGA	Seq Length=72

GGGGCATTACTGAAGCTGACAGCATTCGGGCCGAGATGTCTCGCTCCGTGGCCTTAGCTGTGCTCGCGCTACTCTCTCTTTCTGGCCTGGAGGCTATCCAGCGTACTCCAAAGATTCAGGTTTACTCACGTCATCCAGCAGAGAATGGAAG	Seq Length=151

GCTGACAGCATTCGGGCCGAGATGTCTCGCTCCGTGGCCTTAGCTGTGCTCGCGCTACTCTCTCTTTCTGGCCTGGAGGCTATCCAGCGTACTCCAAAGATTCAGGTTTACTCACGTCATCCAGCAGAGAATGGA	Seq Length=135

GGGCATTCCTGAAGCTGACAGCATTCGGGCCGAGATGTCTCGCTCCGTGGCCTTAGCTGTGCTCGCGCTACTCTCTCTTTCTGGCCTGGAGGCTATCCAGCGTACTCCAAAGATTCNGGTTTACNNACGTCATNNAGCAGNNANTGGANGA	Seq Length=151

ATTCATGGCAAATTCCATAGCACCGTCATGGCTGAGAACGGGAAGCTTGTCATCAATGGAAATCCCATCACCATCTTCCAGGAGAGAGATCCCTCCAAAATCAAGTGGGGCGATGCTGGCGCTGAGTACGTCGTGGAGTCCACTAGCGT	Seq Length=149

GATTGCTGAAGCTGACAGCATTCGGGCCGAGATGTCTCGCTCCGTGGCCTTAGCTGTGCTCGCGCTACTCTCTCTTTCTGGCCTGGAGGCTATCCAGCGTACTCCAAAGATTCAGGTTTACTCACGTCATCCAGCAGAGAATGGA	Seq Length=145

GGGGCATTCCTGAAGCTGACAGCATTCGGGCCGAGATGTCTCGCTCCGTGGCCTTAGCTGTGCTCGCGCTACTCTCTCTTTCTGGCCTGGAGGCTATCCAGCGTACTCCAAAGATTCAGGTTTACTCACGTCATCCAGCAGAGAATGGAAG	Seq Length=151

GGCATTCCTGAAGCTGACAGCATTCGNNNNGAGGTGTCTCGCTCCGTGGCCTTAGCTGTGCTCGCGCTACTCTCTCTTTCTGGCCTGGAGGCTATCCAGCGTACTCCAAAGATTCAGGTTTACTCACGTCATCCAGCAGAGAATGGAAAAT	Seq Length=151

GGCTTACGGGAATCCAGTGGTGGTACATGGATCGAGGGTTCCTTTGTGCTGCATTTTTTACTGCCTCTCTCCTGAGTTGTCGGGATAGATTCTGCAGGCTCTTGTGCTAGCCCAAAGGTGCCCAGCCTTGACTCCACTTCCGTGTCTTTGA	Seq Length=151

ATACCGCCAGAAGCACCAGGAGCTGCAAGCCATG	Seq Length=34

GCATGTTCCAATATGATTCCACCCATGGCAAATTCCATGGCACCGTCAAGGCTGAGAACGGGAAGCTTGTCATCAATGGAAATCCCATCACCATCTTCCAGGAGCGAGATCCCTCCAAAATCAAGTGGGGCGATGCTGGCGCTGAGTACGT	Seq Length=151

GTTCAAAATCAAGTGGGGCGATGCTGGCGCTGAGTACGTCGTGGAGTCCACTGGCGTCTTCACCACCATGGAGAAGGCTGGGGCTCATTTGCAGGGGGGAGCCAAAAGGGTCATTATCTCTGCCCCCTCTGCTGACGCCCCCATGTTCGT	Seq Length=150

CTCCGCCCCGACGCACCCCCGCCACGCAGTTTTATCCGGTAAAGCGAATGACTAGAGGTCTTGGGGCCGAAACGATCTCAACCTATTCTCAAACTTTAAATGGGTAAGAAGCCCGGCTCGCTGGCGTGGAGCNGNGCGTGGAATGCGAGTN	Seq Length=151

TAGTGGGGCGATGCTGGCGCTGAGTACGTCGTGGGGTCCACTGGCGTCTTCACCACCATGGAGAAGGCTGGGGCTCATTTGCAGGGTGGAGCCAAAAGGGTCATCATCTCTGCCCCCTCTGCTGACGCCCCCATGTTCGTCATGGGTGTGA	Seq Length=151

TCATTGCACCTCAACTACATGGTTTACATGTTCCAATATGATTCCACCCATGGCAAATTCCATGGCACCGTCAAGGCTGAGAACGGGAAGCTTGTCATCAATGGAAATCCCATCACCATCTTCCAGGAGCGAGATCCCTCCAAAATCAAGT	Seq Length=151

CGTCAACGGATTTGGTCGTATTGGGCGNNTGGTCACCAGGGCTGCTTTTAACTCTGGTAAAGTGGATATTGTTGCCATCAATGACCCCTTCATTGACCTCAACTACATGGTTTACATGTTCCAATATGATTCCACCCATGGCAAATTCCAT	Seq Length=151

CTTTGTGGCCTGGAGGCTATCCAGCGTNCTCCAAAGATTCAGGTTTACTCACGTCATCCAGCAGAGAATGGA	Seq Length=72

GCCCGCGGCGGGTGTTGACGCGATGTGGTTTCTGGCCAGGGCTCTGAATGTCAAAGTGAAGAAATTCAATGAAGCGCGGGGAAACGGCGGGAGTAACTATGAATCTCTTAAGGGAGCCAAATGACTCGTCATCTAATTAGTGAAGCGCATG	Seq Length=151

GACCGCGGAGGGTGTTGACGCGATGTGGTTTCTGGCCAGGGCTCTGAATGTCAAAGTGAAGAAATTCAATGAAGCGCGGGGAAACGGGGGGAGTAACTATGAATCTCTTAAGGGAGCCAAATGCCTCGTCATATAATTAGTGAAGCGCATG	Seq Length=151

GGGGCATAACTGAAGCTGACAGCATTCGGGCCGAGATGTCTCGCTCCGTGGCCTTAGCTGTGCTCGCGCTACTCTCTATTTATGGACTGGAGGCTATAGAGAGTAATAAAAAGATTCAGGCTTACTAAAGTCCTGGAGCATCGACT	Seq Length=146

GGGGGCATTCCTGAAGCTGACAGCATTCGGGCCGAGATGTCTCGCTCCGTGGCCTTAGCTGTGCTCGCGCTACTCTCTCTTNCTGGCCTGGAGGCTATNNAGCGTACTCCAAAGATTCNNNTTTACTNACGTCATNNAGCAGAGAATNNAA	Seq Length=151

ACTGGCCTGGAGGCTATCCAGCGTACTCCAAAGATTCAGGTTTACTCACGTCATCCAGCAGAGAATGGA	Seq Length=69

TTGGCTGTGCTCGCGCTACTCTCTCTTTCTGGCCTGGAGGCTATCCAGCGTACTCCAAAGATTCAGGTTTACTCACGTCATCCAGCAGAGAATGGA	Seq Length=96

TTCTGGCCTGGAGGCTATCCAGCGTACTCCAAAGATTCAGGTTTACTCACGTCATCCAGCAGAGAATGGA	Seq Length=70

GGGGCATTCCTGAAGCTGACAGCATTCGGGCCGAGATGTCTCGCTCCGTGGCCTCAGCTGTGCTCGCGCTACTCTCTCTTTCTGGCCTGGAGGCTATCCAGCGTACACCAAAGATTAAGGTTTACTCACGTCATCCAGCAGAGAATGGAAG	Seq Length=151

TTCTGGCCTGGAGGCTATCCAGCGTACTCCAAAGATTCAGGTTTACTCACGTCATCCAGCAGAGAATGGA	Seq Length=70

GAAGCTGGCAGCATTCGGGCCGAGATGTCTCGCTCCGTGGCCTTAGCTGTGCTCGCGCTACTCTCTCTTTCTGGCCTGGAGGCTATCCAGCGTACTCCAAAGATTCAGGTTTACTCACGTCATCCAGCAGAANANGGAAGATCGGAAGNGA	Seq Length=151

GGTTTACTCACGTCATCCAGCAGAGAATGGA	Seq Length=31

TTCTGGCCTGGAGGCTATCCAGCGTACTCCAAAGATTCAGGTTTACTCACGTCATCCAGCAGAGAATGGA	Seq Length=70

TCAAGGTGCTCTTCTACGACCCTTACTTGTCGGATGGCGTGGAGCGGGCGCTGGGGCTGCAGCGTGTCAGCACCCTGCAGGACCTGCTCTTCCACAGCGACTGCGTGACCCTGCACTGCGGCCTCAACGAGCACAACCACCACCTCATCAA	Seq Length=151

TACGGTCTGGAGGCTATCCAGCGTACTCCAAAGATTCAGGTTTACTCACGTCATCCAGCAGAGAATGGA	Seq Length=69

GTCTGGCCTGGAGGCTATCCAGCGTACTCCAAAGATTCAGGTTTACTCACGTCATCCAGCAGAGAATGGA	Seq Length=70

ATTCGGGCCGAGATGTCTCGCTCCGTGGCCTTAGCTATGCTCGCGCTACTCTCTCTTTCTGGCCTGGAGGCTATCCAGCGTACTCCAAAGATTCAGGTTTACTCACGTCATCCAGCAGAGAATGGA	Seq Length=126

GGGGCATTCCTGAAGCTGACAGCATTCGGGCCGAGATGTCTCGCTCCGTGGCCTTAGCTGTGCTCGCGCTACTCTCTCTTTCTGGCCTGGAGGCTATCCAGCGTACTCCAAAGATTCAGGTTTACTCACGTCATCCAGCAGAGAATGGAAG	Seq Length=151

TGGGGCATTCCTGAAGCTGACAGCATTCGGGCCGAGATGTCTCGCTCCGTGGCCTTAGCTGTGCTCGCGCTACTCTCTCTTTCTGGCCTGGAGGCTATCCAGCGTACTCCAAAGATTCAGGTTTACTCACGTCATCCAGCAGAGAATGGAA	Seq Length=151

TTCCTGACGACACTCTTTCTCTACACGACGTT	Seq Length=32

GGCTACTCCAAAGATTCAGGTTTACTCACGTCATCCAGCAGAGAATGGA	Seq Length=49

CTCTTTCAGGCCTGGAGGCTATCCAGCGTACTCCAAAGATTCAGGTTTACTCACGTCATCCAGCAGAGAATGGA	Seq Length=74

ACAGCCACCACCTCATCAACGACTTCANNGTCAAGCAGATGAGACAAGGGGCCTTCCTGGTGAACACAGCCCG	Seq Length=73

TTGCTGGGCTGGAGGCTATCCAGCGTACTCCAAAGATTCAGGTTTACTCACGTCATCCAGCAGAGAATGGA	Seq Length=71

AAAAAAGAAAAAAGGAAATGAAGAAAAAAAAAAACAGAAAAAAACAAAAAGAAAAGATAGAAAAGAGAAAAAAAAAAAAAGAAAAGGAGAAAAGAAAAAAGAAAAAAAAGAAGAAAAAAAAAAAAAACAAAAAAAAAAAGAAGAAAAANNG	Seq Length=151

GATTCCTGGAGCTGACAGGATTCGGGCCGAGATGTCTCGCACCGTGGCCTTAGCTGTGCTCGCGCTACTATCTCTTTCTGGCCAGGAGGCTAACCAGCATACTACAAAGATTCAAGTTTACTAACGTCATCCAGCAGAGAATGGA	Seq Length=145

NCCGGGACAAGGCCTTCGGCTTCAACNNNCTCTTCTACGACCCTTACTTGTCGGATGGCGTGGAGCGGGCGCTGGGGCTGCAGCGTGTCAGCACCCTGCAGGACATGCTCTTCAACAGCGACTGCGTGACCCTGGACTGCGGCCTCAACGA	Seq Length=151

AGAAAAAGAGGAGGGAGAGAAAGAAAGAAAAAAGAGGTGAGAGGAGAAGAAGAAGAAAAAGAAAGAAAGAGGAGGGGAAGCAAGAGAGAAAAGAGAAAGAGAGAAGAAGAGTACGATATAGAAATTAAAAAAGAAAAGGAGGACTGATACA	Seq Length=151

GGGCATTCCTGAAGCTGACAGCATTCGGGCAGAGATGTCTCGCTCCGTGGCATTAGAAGTGCTCGCGCTACTCTCTCTTTCTGGCCTGGAGGCTATCCAGCGTACTCCAAAGATTCAGGTTTACTCACGTCATNNAGCAGAGAATGGA	Seq Length=148

CCAAAATCCAGTAGGGCGATGCTGGCGCTGAGTACGTCGTGGAGTCCACGGGCGTCTTCACCACCATGGAGAAGGCTGGGGCTCATTTGCAGGGGGGAGCCAAAAGGGTCATCATCTCTGCCCCCTCTGCTGATGCCCCCATGTTCGTCAT	Seq Length=151

GCTCGCGCTACTCTCTCTTTCTGGCCNNNAGGCTATCCAGCGTACTCCAAAGATTCAGGTTTACTCACGTCATCCAGCAGAGAATGGA	Seq Length=88

CTCCTGGCCTGGAGGCTATCCAGCGTACTCCAAAGATTCAGGTTTACTCACGTCATCCAGCAGAGAATGGA	Seq Length=71

GGGGCATTCCTGAAGCTGACAGCATTCGGGCCGAGATGTCTCGCTCCGTGGCCTTAGCTGTGCTCGCGCTACTCTCTCTTTCTGGCCTGGAGGGTATCCAGCGTACTCCAAAGATTCAGGTTTACTCACGTCATCCAGCAGAGAATGGAAG	Seq Length=151

ATCTGTGGTAATTCTAGAGCTAATACATGCCGACGGGCGCTGACCCCCTTCGCGGGGGGGATGCGTGCATTTATCAGATCAAGACCTGCCCCGAC	Seq Length=95

CTGAGGCCTCAACGAGCACAACCACCACCTCATCAACGACTTCACCGTCAAGCAGATGAGACAAGGGGCCTTCCTGGTGAACACAGCCAG	Seq Length=90

CAGTACTCCAANGATTCAGGTTTACTCACGTCATCCAGCAGAGAATGGA	Seq Length=49

TCTCTGNCCCCTCTGCTGATGCCCCCATGTTCGTCATGGGNGTGAANCA	Seq Length=49

TTACTGGCCTGGAGGCTATCCAGCGTANTCCAAAGATTCAGGTTTACTCACTTCATCCAGCAGAGAATGGA	Seq Length=71

GGCCTACTTGTCGGATGGCGTGGAGCTGGCGCTGGGGCTGCAGCGTGTCAGCACCCTGCAGGACCTGCTCTTCCACAGCGACTGCGTGACCCTGCACTGCGGCCTCAACGAGCACAACCACCACCTCATCAACGACTTCACCGTCAAGCAG	Seq Length=151

AAGTAAACCAGGCATTCCCAAATTACTNGAAGGGAGTAAAAATTCAATACAGTGGGAGAAAGCTGAAGATAATGGATGTAGAATTACATACTATATCATTGAGATAAGAAAGAGCACTTCAAATAATTTACAGAACCAGAATTTAAGGAGG	Seq Length=151

CTCCAAAATCAAGTGGGGCGATGCTGGCGCTGAGTACGTCGTGGAGTCCACTGGCGTCTTCACCACCATGGAGAAGGCTGGGGCTCATTTGCAGGGGGGAGCCAAAGGGTCATCATCTCTGCCCCCTCTGCTGATGCCCCCATGTTCGTCA	Seq Length=151

AGACAACGGATTTGGTCGTATTGGGCGCATGGTCACCAGGGCTGCTTTTAACTCTGGTAATGTGGATATTGTTGCCATCAATGACCCCTTCATTGACCTCAACTAAATGGTTTACATGTTCCAATATGATTCCACCCATGGCAAATTCCAT	Seq Length=151

TGGGGCATTCCTGAAGCTGACAGCATTCAGGCCGAGATGTCTCGCTCCGTGGCCTTAGCTGTGCTCGCGCTACTCTCTCTTTCTGGCCTGGAGGCTATCCAGCGTACTCCAAAGATTCAGGTTTACTCACGTCATCCAGCAGAGAATGGAA	Seq Length=151

GGCATTCCTGAAGCTGACAGCATTCGGGCCGAGATGTCTCGCTCCGTGGCCTTAGCTGTGCTCACGCTACTCTCTCTTTCTGGCCTGGAGGCTATCCAGCGTACTCCAAAGATTCAGGTTTACTCACGTCATCCAGCAGAGAATGGAAGAA	Seq Length=151

CTGCCCCCTCTGCTGACGCCCCCATGTTCGTCATGGGTGTGAACCA	Seq Length=46

CATTTGCTGGGGGGAGCCAAAAGGGTCATCATCTCTGCCCCCTCTGCTGACGCCCCCATGTTCGTCATGGGTGTGAACCA	Seq Length=80

ACTTGCCTGGAGGCTATCCAGCGTACTCCAAAGATTCAGGTTTACTCACGTCATCCAGCAGAGAATGGA	Seq Length=69

CGTGGCCTTAGCTGTGCTCGCGCTACTCTCTCTTTCTGGCCTGGAGGTTATCCAGCGTACTCCAAAGATTCAGGTTTACTCACGTCATCCAGCAGAGAATGGA	Seq Length=103

ATTTCTGGCCTGGAGGCTGTCCAGCGTACTCCAAAGATTCAGGTTTACTCACGTCATCCAGCAGAGAATGGA	Seq Length=72

TTCTGGCCTGGAGGCTATCCAGCGTACTCCAAAGATTCAGGTTTACTCACGTCGTCCAGCAGAGAATGGA	Seq Length=70

TCACGGCCCTTACTTGTCGGATGGCGTGGAGCGGGAGCTGGGGATGCAGAGTGTCAGAACCATGCAGGAACTGATATTACACAGCGAGTGCGTGAAAATGAAATGAAGAATCAACGAGCACCACAAACACCTCATCAACGACATCACCGT	Seq Length=150

CTCAAGNGGGGCGATGCTGGCGCTGAGTACGTCGTGGAGTCCACTGGCGTCTTCACCACCATGGAGAAGGCTGGGGCTCATTTGCAGGGGGGAGCCAAAAGGGTCATCATCTCTGCCCCCTCTGCTGACGCCCCCATGTTCGTCATGGGTG	Seq Length=151

CTCAAGNGGGGCGATGCTGGCGCTGAGTACGTCGTGGAGTNCACTGNCGTCTTCACCACCATGGAGAAGGCTGGGGCTCATTTGCAGGGGGGAGCCAAAAGGGTCATCATCTCTGCCCCCTCTGCTGACGCCCCCATGTTCGTCATGGGTG	Seq Length=151

NTGTGGCCTGGAGGCTATCCAGCGTACTCCAAAGATTCAGGTTTACTCACGTCATCCAGCAGAGAATGGA	Seq Length=70

AGCTGAACAGGAGGCTATCCAGCGTACTCCAAAGATACAGGTTAACTCACGAAATACAGCAGAAAATGGAAGATCAGAAGAGCACACAACAGAACTAAAAACACGAATATAAATAGTATGCCGAATTAAACTAAAAAAAAAAAAAAAAAAA	Seq Length=151

CTTAGTGGCCTGGAGGCTATCCAGCGTACTCCAAAGATTCAGGTTTACTCACGTCATCCAGCAGAGAATGGA	Seq Length=72

GGGGCTTTCCTGAAGCTGACAGCATTCGGGCCGAGATGTCTCGCTCCGTGGCCTTAGCTGTGCTCGCGCTACTCTCTCTTTCTGGCCTGGAGGCTATCCAGCGTACTCCAAAGATTCAGGTTTACTCACGTCATCCAGCAGAGAATGGAAG	Seq Length=151

CGCTCTTTCTGGCCAGGAGGCTATCCAGCGTACTCCAAAGATTCAGGTTTACTCACGTCATCCAGCAGAGAATGGA	Seq Length=76

GGGGTAATGCTGGCGCTGAGTACGTCGTGGAGTCCACTGGCGTCTTCACCACCATGGAGAAGGCTGGGGCTCATTTGCAGGGGGGAGCCAAAAGGGTCATCATCTCTGCCCCCTCTGCTGATGCCCCCATGTTCGTCATGGGTGTGAACCA	Seq Length=151

GGGCATACCTGNAGCTGACAGCATTCGGGCCGAGATGTCTCGCTCCGTGGCCTTAGCTGTGCTCGCGCTACTCTCTCTTTCTGGCCTGGAGGCTATCCAGCGTACTCCAAAGATTCAGGTTTACTCACGTCATCCAGCAGAGAATGGA	Seq Length=148

GTGTGGCCTGGNGGCTATCCAGCGTACTCCAAAGATTCAGGTTTACTCACGTCATCCAGCAGAGAATGGA	Seq Length=70

AGCTGACGGCATTCGGGCCGAGATGTCTCGCTCCGTGGCCTTAGCTGTGCTCGCGCTACTCTCTCTTTCTGGCCTGGAGGCTATCCAGCGTACTCCAAAGATTCAGGTTTACTCACGTCATCCAGCAGAGAATGGA	Seq Length=136

CGACCCCTACTTGTCGGATGGCGTGGAGCGGGCGCTGGGGCTGCAGCGTGTCAGCACCCTGCAGGACCTGCTCTTCCACAGCGACTGCGTGACCCTGCACTGCGGCCTCAACGAGCACAACCACCACCTCATCAACGACTTCACCGTCAAG	Seq Length=151

NGGCATTCCTGAAGCTGACAGCATTCNNNCCGAGATGTCTCGCTCCGTGGCCTTAGCTGTGCTCGCGCTACTCTCTCTTTCTGGCCTGGAGGCTATCCAGCGTACTCCAAAGATTCAGGTTTACTCACGTCATCCAGCAGAGAATGGA	Seq Length=148

GGTTTTGGCAGTGGTTTTGACAACATCGACATCAAGTCGGCCGGGGATTTAGGAATTGCCGTCTGCAACGTACCCGCGGCGTCTGAGGAGGAGACTGCCGACTCGACGCTGTGCCACATCCTGAACCTGTACCGGCGGGCCACCTAGATGA	Seq Length=151

GGTTTTGGCAGTGGTTTTGACAACATCGACATCAAGTCGGCCGGGGATTTAGGCATTGCCGTCTGCAACGTGCCCGCGGCGTCTGAGGAGGAGACGGCCGACTCGACGCTGTGCCACATCCTGAACCTGAACCGGCGGGCCACCTGGCTG	Seq Length=150

TACTGACAGATCGGAAGAGCACACGTNNNNACTCCAGTCACGTGTTTATCTCGTATGCCGTCTTCTGCTTGAAAAAAAAAAAGAAAAAATAATAACAAAAAAGATAAAAAGAAGAAAAAAAAAAAAAAAAAAGAAAAAAAAAAAAAAAAAA	Seq Length=151

GTGGCTTCCTGAAGCTGACAGCATTCGGGCCGAGATGTCTNGCTCCNTGGCCTTAGCTGTGCTCGCGCTACTCTCTCTTTCTGGCCTGGAGGCTATCCAGCGTACTCCAAANATTCAGGNTTACTCACGTCATCCNNCAGAGAATGGANGA	Seq Length=151

TTCTTAATGGAGGCTATCCAGCGTACTACAAAGATTCAGGTTTACTCACGTCATACAGCAGAGAATGGA	Seq Length=69

GCTGGCGCTGAGTACGTCGTGGAGTCCACTGGCGTATTAACCACCATGGAGAAGGCTGGGGCTCATTTGAAGGGGGGAGCAAAAAGGGTCATCATATATGAACAAACTGAGGAAGCCCCCATGTTCGTAATGGNNGTGAACCA	Seq Length=143

CTTTTTGCCTGGAGGCTATCCAGCGTACTCCAAAGATTCAGGTTTACTCACGTCATCCAGCAGAGAATGGA	Seq Length=71

GATTCCGGTTTACTCACGTCATCCAGCAGAGAATGGA	Seq Length=37

GATTCCTGAAGCTGACAGCATTCGGGCCGAGATGTATCGCTCAGTGGCCTTAGCTGTGCTCGCGCTACTATCTCTTAAAGGCCTGGAGGCTATACAGAGTAATAGACAGAGAAAGGTTTACTCACGTCATCCAGCAGAGAATGTA	Seq Length=145

GATTCCTGAAGCTGACAGCATTCGGGCCGAGATGTATCGCTCAGTGGCCTTAGCTGTGCTCGCGCTACTATCTCTTGAAGGCCTGGAGGCTATACAGAGTAATAAACAGAGAAAGGTTTACTCACGTCATCCAGCAGAGAATGTA	Seq Length=145

GATTCCTGAAGCTGACAGCATTCGGGCCGAGATGTATCGCTCAGTGGCCTTAGCTGTGCTCGCGCTACTATCTCTTGAGGGCCTGGAGGCTATACAGAGTAATAAACGGAGAAAGGTTTACTCACGTCATCCAGCAGAGAATGTA	Seq Length=145

CACTCCAAAGATTCAGGTTTACTCACGTCATCCAGCAGAGAATGGA	Seq Length=46

TGCCTGGGGGCTATCCAGCGTACTCCAAAGATTCAGGTGTACACACGTCATCCAGCAGAGAATGGAAGATCGGAAGAGAAAACGTAAGAACTCAAGAAACGAGAGAATAAAGGATGCCGTCTTCTGCTAGAAAAAAAAAAAAGAAAAAAAA	Seq Length=151

CTCTTTCCGGCCTGGAGGCTATCCAGCGTACTCCAAAGATTCAGGTTTACTCACGTCATCCAGCAGAGAATGGA	Seq Length=74

TGATAGACAGGGGGCCTTCCTGGTGAANACAGCCCG	Seq Length=36

GGGGTATTTCTGAAGCTGACAGCATTCGGGCCGAGATGTCTCGCTCCGTGGCCTTAGCTGTGCTCGCGCTACTCTCTCTTTCTGGCCTGGAGGCTATCCAGCGTACTCCAAAGATTCAGGTTTACTCACGTCATCCAGCAGAGAATGGAAA	Seq Length=151

TTCTGGCTTGGAGGCTATCGAGCGTACTCCAAAGATTCGGGTTTACTCACGTAATCCAGCAGAGAAGGGA	Seq Length=70

TACCTTNCTTGTCGGATGGCGTGGAGCGGGCGCTGGGGGNNCAGCGNGTCAGAACCCTGCAGGACCGGCTCTTCCACAGCGACTGCGTGACCCTGCACNNCGGCCTCAACGNGCACAACNNCCACCTCATCAGCGNNGTCACCGTCAANCA	Seq Length=151

CTGCCCCCTCTGCTGACGCCCCCATGTTCGTCATGGGTGTGAACCA	Seq Length=46

GGGGCATTCCTGAAGCTGACAGCATTCGGGCCGAGATGTCTCGCTCCGTGGCCTTAGCTGTGCTCGCGCTACTCTCTCTTTCTGGCCTGGAGGCTATCCAGCGTACTCCAAAGATTCAGGTTTACTCACGTCAGCCAGCAGAGAATGGAAG	Seq Length=151

NTTTCTGGTCTGGAGGCTATCCAGCGTACTCCAAAGATTCAGGTTTACTCACGTCATCCAGCAGAGAATGGA	Seq Length=72

GGAGGCAATCCAGCGTACTCCAAAGATTCAGGTTTACTCACGTCATCCAGCAGAGAATGGA	Seq Length=61

CTTGGGCGATGCTGGCGCTGAGTACGTCGTGGAGTCCACTGGCGTCTTCACCACCATGGAGAAGGCTGGGGCTCATTTGCAGGGGGGAGCCAAAAGGGTCATCATCTCTGCCCCCTCTGNTGACGCCCCCATGTTNNTCATGGGTGTGNA	Seq Length=150

GATGCTGACAGCATTCGGGCCGAGATNNNTCGCTCCGTGGCCTTAGCTGTGCTCGCGCTACTCTCTCTTTCTGGCCTGGAGGCTATCCAGCGTACTCCAAAGATTCAGGTTTACTAAAGTCATCCAGCAGAGAATGGA	Seq Length=138

TCTTTCTGGCCTGGAGGCTATCCAGCGNACTCCAAAGATTCAGGTTTACTCACGTCATCCAGCAGAGAATGGA	Seq Length=73

GCCTTCCCTCGGGAAAAACTGACTCTGCGTCTCTTGCTGGGAAGTGGAGCCTTTGGAGAAGTGTATGAAGGAACAGCAGTGGACATCTTAGGAGTTGGAAGTGGAGAAATCAAAGCAGCAGTGAAGACTTTGAAGAAGGGTTCCACAGAC	Seq Length=150

CGCGTGGCCTGGAGGCTATCCAGCGTACTCCAAAGATTCAGGTTTACTCACGTCATCCAGCAGAGAATGGA	Seq Length=71

TTCTTGCTGGAGGCTATCCAGCGTACTNCAAAGATTCAGGTTTACTCACGTCATCCAGCAGAGAATGGA	Seq Length=69

TTTACTGGCCTGGAGGCTATCCAGCGTACTCCAAAGATTCAGGTTTACTCACGTCATCCAGCAGAGAATGGA	Seq Length=72

TGATTCAGGCATACTCACGTCATCCAGCAGAGAATGGA	Seq Length=38

ACTCCAAAGATTCAGGTTTACTCACGTCATCCAGCAGAGAATGGA	Seq Length=45

CTGCCCCCTCTGCTGACGCCCCCATGTTCGTCATGGGTGTGAACCA	Seq Length=46

TACTGCCTGGAGGCTATCCAGCGTACNNNAAAGATTCAGGTTTACTCACGTCATCCAGCAGAGAATGAA	Seq Length=69

GACAGCAATCGGGCCGAGATGTCTCGCTCCGTGGCCTTAGCTGTGCTCGCGCTACTCTCTCTTTCTGGCCTGGAGGCTATCCAGCGTACTCCAAAGATTCAGGTTTACTCACGTCATCCAGCAGAGAGTGGA	Seq Length=132

NTTTCTGGCCTGGAGGCTATCCAGCGNNNTCCAAAGATTCAGGTTTACTCACGTCATCCAGCAGAGAATGGA	Seq Length=72

GATCTGACCTGGAGGCTATCCAGCGTACTCCAAAGATTCAGGTTTACTCACGTCATACAGCAGAGAATGGA	Seq Length=71

GCTCTGGCCTGGAGGCTATCCAGCGTNNNNCAAAGATTCAGGTTTACTCACGTCATCCAGCAGAGAATGGA	Seq Length=71

CCAACATCAAGTGGGGCGATGCTGGCGCTGAGTACGTCGTGGAGTCCACTGGCGTCTTCACCACCATGGAGAAGGCTGGGGCTCATTTGCAGGGGGGAGCCAAAAGGGTCATCATCTCCGCCCCCTCTGCTGATGCCCCCATGTTCGTCAT	Seq Length=151

GGCAATGGAGGCTATCCAGCGTACTCCAAAGATTCAGGTTTACTCACGTCATCCAGCAGAGAATGGA	Seq Length=67

GCATTGGGGCCGAGATGTCTCGCTCCGTGGCCTTAGCTGTGCTCGCGCTACTCTCTCTTNCTGGCCTGGANGCTATCCAGCGTACTCCAAAGATTCAGGTTTACTCACGTCATCCAGCAGAGAATGGA	Seq Length=128

NGCTGAGTACGTCGTGGAGTCCACTGGCGTCTTCACCACCATGGAGAAGGCTGGGGCTCATTTGCAGGGGGGAGCCAAAAGGGTCATCATCTCTGCCCCCTCTGCTGACGCCCCCATGTTCGTCATGGGTGTGAACCA	Seq Length=138

TGCTGGCCTGGAGGCTATCCAGCGTACTCCAAAGATTCAGGTTTACTCACGTCATCCAGCAGAGAATGGA	Seq Length=70

CATTCTCTGGCCTGGAGGCTATCCAGCGTACTCAACAGATTCAGGTTTACTCACGTCATGAAGCAGAGAATGGAAGATCGTAAGACAACACGTATGACCTGGAGAGATGTGTTTATATCGTATGCCGTGTTCTGCTTGAAAAAAAAAAAAA	Seq Length=151

GCTGAGAACGGGAAGCTTGTCATCAATGGAAATCCCATCACCATCTTCCAGGAGCGAGATACCTCCAAAATCAAGTGGGGCGATGCTGGCGCTGAGTACGTCGTGGAGTCCACTGGCGTCTTCACCACCATGGAGAAGGCTGGGGCTCATT	Seq Length=151

NCAGTGCCTTAGCTGTGCTCGCGCTACTCTCTCTTTCTGGCCTGGAGGCTATCCAGCGTACTCCAAAGATTCAGGTTTACTCACGTCATCCAGCAGAGAATGGA	Seq Length=104

CTGATGACCTGGAGGCTATCCAGCGTACTCCAAAGATTCAGGTTTACTCACGTCATCCANCAGAGAATGGA	Seq Length=71

GATGTCACCATGTTCGTCATGGGTGTGAACCA	Seq Length=32

GGGCATGCTGAAGCTGACAGCATTCGGGCCGAGATGTCTCGCTCCGTGGCCTTAGCTGTGCTCGCGCTACTCTCTCTTTCTNGCCTGGAGGCTATCCANNGAACTCCAAAGATTCAGGNNNACTCACNTCNTCCAGCAGAGAATGGNNNAA	Seq Length=151

CAATGGGGCGATGCTGGCGCTGAGTACGTCGTGGAGTCCACTGGCGTCTTCACCACCATGGAGAAGGCTGGGGCTCATTTGCAGGGGGGAGCCAAAAGGGTCATCATCTCTGCCCCCTCTNCTGATGCCCCCATGTTCGTCATGGGTGNGA	Seq Length=151

TAGCCTGGAGGCTATCCAGCGTACTCAAAAGATTCAGGTTTACTCACGTCATCCAGCAGAGAATGGA	Seq Length=67

CACCGTCAGGCAGATGAGACAAGGGGCCTTCCTGGTGAACACAGCCCG	Seq Length=48

CGCGCTACTCTCTCTTTCTGGCCTGGAGGCTATCCAGCGTACTCCAAAGATTCAGGTTTACTCACGTCATCCAGCAGAGAATGGA	Seq Length=85

GGCCTTACCTGTGCTCGTGCTACTCTCTCTTTCTGGCCTGGAGGCTATCCAGCGTACTCCAAAGATTCAGGTTTACTCACGTCATCCAGCAGAGAATGGA	Seq Length=100

GATTCCTGAAGCTGACAGCATTCGGGCCGAGATGTCTCGCTCCGTGGCCTTATCTGTGCTCGCGCTACTCTCTCTTTCTGGCCTGGAGGCTATCCAGCGTACTCCAAAGATTCAGGTTTACTCACGTCATCCAGCAGAGAATGGA	Seq Length=145

GGGCTTTCCTGAAGCTGACAGCATTCGGGCCGAGATGTCTCGCTCCGTGGCCTTAGCTGTGCTCGCGCTACTCTCTCTTTCTGGCCTGGAGGCTATCCAGCGTACTCCAAAGATTCAGGTTTACTCACGTCATCCAGCAGAGAATGGA	Seq Length=148

CTGGTATTGTGGATATTGTTGCCATCAATGACCCCTTCATTGACCTCAACTACATGGTTTACATGTTCCAATATGATTCCACCCATGGCAAATTCCATGGCACCGTCAAGGCTGAGAACGGGAATCTTGTCATCAATGGAAATCCCATCA	Seq Length=150

CTGGTATTGTGGATATTGTTGCCATCAATGACCCCTTCATTGACCTCAACTACATGGTTTACATGTTCCAATATGATTCCACCCATGGCAAATTCCATGGCACCGTCAAGGCTGAGAACGGGAATCTTGTCATCAATGGAAATCCCATCA	Seq Length=150

GGCACCGTCAAGGCTGAGAACGGGAANNNTGTCATCAATGGAAATCCCATCACCATCTTCCAGGAGCGAGATCCCTCCAAAATCAAGTGGGGCGATGCTGGCGCTGAGTACGTCGTGGAGTCCACTGGCGTCTTCACCACCATGGAGAAGG	Seq Length=151

TGGGGCATTCCTGAAGCTGACAGCATTCGGGCCGAGATGTCTCGCTCCGTGGCCTTAGCTGTGCTCGCGCTACTCTCTCTTTCTGGCCTGGAGGCTATCCAGCGTACTCCAAAGATTCAGGTTTACTCACGTCANCCAGCAGAGAATGGAA	Seq Length=151

CTTCTTNCCTGGAGGCTATCCAGCGTACTCCAAAGATTCANGTTTANTCACGTCATCCAGCAGAGAATGGA	Seq Length=71

TTATTGGCCTGGAGGCTATCCAGCGTACTCCAAAGATTCAGGTTTACTCACGTCATCCAGCAGAGAATGGA	Seq Length=71

TGATTCAGGTTTACTCACGTCATCCAGCAGAGAATGGA	Seq Length=38

TTCTGGCCAGGAGGCTATCCAGCGTACTCCAAAGATTCAGGTTTACTCACGTCATCCAGCAGAGAATGGA	Seq Length=70

CCTTACGCGACACTCTTTCCCTACACGATGC	Seq Length=31

NGCCTGGGAGCAGCAGGGGGAGCAGGTGGGGTGGGGACGGGAGTACTGCTGGGGAAGGCACTGGGGAGGCTCATTGGCATCTGGAGGGACTCCATGCTCCTGTGCAGGCCTGAGAGTTTGGGGTACATGCGGGTCTCTTTTGGCACACTGA	Seq Length=151

CTGGGGCTGAGATGTCTCGCTCCGTGGCCTTAGCTGTGCTCGCGCTACTCTCTCTTTCTGGCCTGGAGGCTATCCAGCGTACTCCAAAGATTCAGGTTTACTCACGTCATCCAGCAGAGAATGGA	Seq Length=125

NTCTGGCCTGGAGGCTATCCAGCGTACTCCAAAGATTCAGGTTTACTCACGTCATCCAGCAGAGAATGGA	Seq Length=70

ACTCTGCCCCCTCTGCTGACGCCCCCATGTTCGTCATGGGTGTGAACCA	Seq Length=49

TGAATTCAGGTTTACTCACGTCATCCAGAAGAGAATGGA	Seq Length=39

CCATTACTTGTCGGATGGCGTGGAGCGGGCGCAGGTCCTGCAGGGTGCTGACACGCTGCAGGACCTGCTCTTCCACAGCGACTGCGTGACCCTGCACTGCGGCCTCAACGAGCACAACCACCACCTCATCAACGACTTCACCGTCAAGCAG	Seq Length=151

CCATTACTTGTCGGATGGCGTGGAGCGGGCGCAGGTCCTGCAGGGGGCTGACACGCTGCAGGACCTGCTCTTCCACAGCGACTGCGTGACCCTGCACTGCGGCCTCAACGAGCACAACCACCACCTCATCAACGACTTCACCGTCAAGCAG	Seq Length=151

TTGCTGGCCTGGAGGCTATCCAGCGTACTCCAAAGATTCAGGTTTACTCACGTCATCCAGCAGAGAATGGA	Seq Length=71

AGATTCAGGTTTACTCACGTCATCCAGCAGAGAATGGA	Seq Length=38

GGGCATTCCTGAAGCTGACAGCATTCGGGCCGAGATGTCTCGCTCCGTGGCCTTAGCTGTGCTCGCGCTACTCTCTCTTTCTGGCCTGGAGGCTATCCAGCGTACTCCAAAGATTCAGGTTTACTCACGTCATCCAGCAGAGAATGGA	Seq Length=148

GGTGACTCTAGATAACCTCGGGCCGATCGCACGCCCCCCGTGGCGGCGACGACCCATTCGAACGTCTGCCCTATCAACTTTCGATGGTAGTCGCCGTGCCTACCATGGTGACCACGTGTGACGGGGAATCAGGGTTCGATTCCGGAGAGGG	Seq Length=151

GTGGCCTGAGCTGTGCTCGCGCTACTCTCTCTTTCTGGCCTGGAGGCTATCCAGCGTACTCCAAAGATTCAGGTTTACTCACGTCATCCAGCAGAGAATGGA	Seq Length=102

NGTCAGCCGAGCCACATCGCTGAGACACCATGGGGAAGGTGAAGGTCGGAGTCAACGGATTTGGTCGTATTGGGCGCCTGGTCACCAGGGCTGTTTTTAACTCTGGTGAAGTGGATATTGTTGCCATCAACGACCCCTTCATTGACCTCAA	Seq Length=151

GATTTGGCCGTATTGGGCGCCTGGTCACCAGGGCTGCTTTTAACTCTGGTAAAGTGGATATTGTTGCCATCAATGACCCCTTCATTGACCTCAACTACATGGTTTACATGTTCCAATATGATTCCACCCATGGCAAATTCCATGGCACCGT	Seq Length=151

GATTTGGCCGTATTGGGCGCCTGGTCACCAGGGCTGCTTTTAACTCTGGTAAAGTGGATATTGTTGCCATCAATGACCCCTTCATTGACCTCAACTACATGGTTTACATGTTCCAATATGATTCCACCCATGGCAAATTCCATGGCACCGT	Seq Length=151

AGCCTAGAGGCTATCCAGCGTACTCCAAAGATTCAGGTTTACTCACGTCATCCAGCAGAGAATGGA	Seq Length=66

ACGGGCGATGCTGGCGCTGAGTACGTCGTGGAGTCCACTGGCGTCTTCACCACCATGGAGAAGGCTGGGGCTCATTTGCAGGGGGGAGCCAAAAGGGTCATCATCTCTGCCCCCTCTGCTGATGCCCCCATGTTCGTCATGGGTGTGAAC	Seq Length=150

GCCTGTGCTCGCGCTACTCTCTCTTTCTGGCCTGGAGGCTATCCAGCGTACTCCAAAGATTCAGGTTTACTCACGTCATCCAGCAGAGAATGGA	Seq Length=94

GGGTCTCTTGCTGGGAAGTGGAGCCTTTGGAGAAGTGTATGAAGGAACAGCAGTGGACATCTTAGGAGTTGGAAGTGGAGAAATCAAAGTAGCAGTGAAGACTTTGAAGAAGGGTTCCNNNGACCAGGAGAAGATTGAATTCCTGAGNNCG	Seq Length=151

NCTAAATGCCTCGTCATCTAATTAGTGACGCGCATGAATGGATGAACGAGATTCCCACTGTCCCTACCTACTATCCAGCGAAACCACAGCCAAGGGAACGGGCTTGGCGGAATCAGCGGGGAAAGAAGACCCTGTTGAGCTTGACTCTAGT	Seq Length=151

CTGCACGCCGGCCTCAACGAGCACAACCACCACCTCATCAACGACTTCACCGTCAAGCAGATGAGACAAGGGGCCTTCCTGGTGAGCACAGCCCG	Seq Length=95

TTGCTGGTAAGTGGAGCCTTTGGAGAAGTGTATGAAGGAACAGCAGTGGACATCTTAGGAGTTGGAAGTGGAGAAATCAAAGTAGCAGTGAAGACTTTGAAGAAGGGTTCCACAGACCAGGAGAAGATTGAATTNCTG	Seq Length=138

GGCCTTAGTTGTGCTCGCGCTACTCTCTCTTTCTGGCCTGGAGGCTACCCAGCGTACTCCAAAGATTCAGGTTTACTCACGTCATCCAGCAGAGAATGGA	Seq Length=100

GGCCTTAGTTGTGCTCGCGCTACTCTCTCTTTCTGGCCTGGAGGCTACCCAGCGTACTCCAAAGATTCAGGTTTACTCACGTCATCCAGCAGAGAATGGA	Seq Length=100

GTACTGCGGCCTCAACGAGCACAACCACCACCTCATCAACGACTTCACCGTCAAGCAGATGAGACAAGGGGCCTTCCTGGTGAACACAGCCCG	Seq Length=93

GGTCTGGGGGCTATCCAGCGTACTCCAAAGATTCAGGTTTACTCACGTCATCCAGCAGANAATGGA	Seq Length=66

NTGAACTGGCCCCTGCACCCGCGGCCCNTGGTGGCATTGCTGGATGGCCGGGACTGCACAGTGGAGATGCCCATCCTGAAGGACGTGGCCACTGTGGCCTTCTGCGACGCGCAGTCCACGCAGGAGATCCATGAGAAGGTCCTGAACGAGG	Seq Length=151

TTTCAGGTTTACTCACGTCATCCAGCAGAGAATGGA	Seq Length=36

TTTGCTGGGAAGTGGAGCCTTTGGAGAAGTGTATGAAGGAACAGCAGTGGACATCTTAGGAGTTGGAAGTGGAGAAATCAAAGTAGCAGTGAAGACTTTGAAGAAGGGTTCCACAGACCAGGAGAAGATTGAATTCCTG	Seq Length=139

TCTTCTGCACTGCGGCCTCAACGAGCACAACCACCACCTCATCAACGACTTCACCGTCAAGCAGATGAGACAAGGGGCCTTCCTGGTGAACACAGCCCG	Seq Length=99

NGCTTTCCTGAAGCTGACAGCATTCGGGACGAGATGTCTCGCTCCGTGGCCTTAGCTGTGCTCGCGCTACTCTCTCTTTCTGGCCTGGAGGCTATCCAGCGTACTCCAAAGATTCAGGTTTACTCACGTCATCCAGCAGAGAATGGA	Seq Length=147

GAGGCATGCCTGAAGCTGACAGCATTCGGGCCGAGATGTCTCGCTCCGTGGCCTTAGCTGTGCTCGCGCGACTCTCTCTTTCTGGCCTGGAGGCTATCCAGCGTACTCCAAAGATTCAGGTTTACTCACGTCATCCAGCAGAGAATGGAAG	Seq Length=151

TAATTACATGGATTACATGTTCCAATATGATTCCACCCATGGCAAATTCAATGGCACCGTCAAGGCTGAGAACGGGAAGCTTGTAATCAATGGAAATCCCATCACCATCTTCCAGGAGCGAGATACCTCCAAAAACAAGTGGAGCGATG	Seq Length=149

TTCTGGCCTGGAGGCTATCCAGCGTACTCCAAAGATTCAGGTTTACTCACGTCATCCAGCAGAGAATGGA	Seq Length=70

TTAACTCTGGTAAAGTGGATATTGTTGCCATCAATGACCCCTTCATTGACCTCAACTACATGGTTTACATGTTCCAATATGATTCCACCCATGGCAAATTCCATGGCACCGTCAAGGCTGATAACTGGAAGCTTGTCATCAATGGAAANC	Seq Length=150

CCCTTTCTGGCCTGGAGGCTATCCAGCGTACTCCAAAGATTCAGGTTTACTCACGTCATCCAGCAGAGAATGGA	Seq Length=74

TTCTGGACTGGAGGCTATCCAGCGTACTCCAAAGATTCAGGTTTAATAAAGTAATAGAGCAGAGAATGGAAGATAGGAAGAGCACAAGTATGAAATACAGTCAAGTGTTTATCTCGTATGCCGTCTTCTGCTTGAAAAAAAAAAAAAG	Seq Length=148

TTCTGGACTGGAGGCTATCCAGCGTACTCCAAAGATTCAGGTTTAATAACGTAATAAAGCAGAGAATGGAAGATAAGAAGAGCACAAGTCTGAAATACAGTCACGTGTTTATCTCGTATGCCGTCTTCTGCTTGAAAAAAAAAAAAAAAAA	Seq Length=151

CCGCTGGCCTGGAGGCTATCCAGCGTACTCCAAAGATTCAGGTTTACTCACGTGATACANAAGAGAATGGAAGATAGTCAGAGCACACGTATGAAATCCAGTAAAGTGTTTATCTCGTATGCCGTCTTCTGCTTGAAAAAAAAAAAAATAA	Seq Length=151

NCGCCTGGCGGCTATCCAGCGTACTCCAAAGATTCAGGTTTACTCACGTCATCCAGCAGAGAATGGA	Seq Length=67

ACGACCCTTACTTGTCGGATGGCGTGGAGCGGGCGCTGGGGCGGCAGCGTGTCAGCACCCTGCAGGACCTGCTCTTCCACAGCGACTGCGTGACCCTGCAATGCGGACTCAACGAGCAAAACCAACACCTCATCAACGACTTCACCGTCAA	Seq Length=151

ACGACCCTTACTTGTCGGATGGCGTGGAGCGGGCGCTGGGGCTGCAGCGTGTCAGCACCCTGCAGGACCTGCTCTTCCACAGCGACTGCGTGACCCTGCACTGCGGCCTCAACGAGCACAACCAACACCTCATCAACGACTTCACCGTCAA	Seq Length=151

CAGGTTTATTCACGTCATCCAGCAGAGAATGGA	Seq Length=33

TGTCTGGCCTGGAGGCTATCCAGCGTACTCCAAAGATTCAGGTTTACTCACGTCATCCAGCAGAGAATGGA	Seq Length=71

CTGCCCCCTCTGCTGATGCCCCCATGTTCGTCATGGGTGTGAACCA	Seq Length=46

CGCTGGCCTGGAGGCTATCCAGCGTACTCCAAAGATTCAGGTTTACTCACGTCATCCAGCAGAGAATGGA	Seq Length=70

AATCAAAATAAAGTGGGGAGATGCTGGNGCTGAGTACGACGTGGAGTCCACTGGCGTCTTCACCACCATGGAGAAGGAAGGGGCTAATTTGCAGGAGGGAGACAAAAGGGAAAACATCTCTGCCCCCTATGCTGATGCCCCCATGTTCGT	Seq Length=150

GGGGCATTCCTGAAGCTGACAGCATTCGGGCCGAGATGTCTCGCTCCGTGGCCTTAGCTGTGCTCGCGCTACTCTCTCTTTCTGGCCTGGAGGCTATCCAGCGTACTCCAAAGATTCAGGTTTACTCACGTCATCCAGCAGAGAATGGAAG	Seq Length=151

AAAAAGATAGATCGGAAGAGAAAAAGAATGAACTCCAGTCACGTGTTTATCTCGTATGCCGTCTTCTGCTTGAAAAAAAAAAAAGAAAAAAACAAAAAACATATAGAGAAAGAAAGAAAAACAATGATAAAAAGAAAAAAAAAAGAAGAAA	Seq Length=151

GCTCTTCTACGACCCTTACTTGTCGGATGGCGTGGAGCGGGCGCTGGGGCTGCAGCGTGTCAGCACCCTGCAGGACCTGCTCTTCCACAGCGACTGCGTGACCCTGCACTGCGGCCTCAACGAGCACAACCACCACCTCATCAACGACTT	Seq Length=150

AAAAATCCAAAATCAAGTGGGGAGATGATGGCGCTGAGTACGTCGTGGAGTCCACTGGCGTCTTCACCACCATGGAGAAGGCTGGGGCTCATTTGCAGGGGGGAGCCAAAAGGGTCATCATCTCTGCCCCCTCTGCTGACGCCCCCATGTT	Seq Length=151

NCACAGCGGAGATGCCCATCCTGAAGGNCGTGGCCACTGTGGCCTTCTGCGACGCGCAGTCCACGCAGGAGATCCATGAGAAGGTCCTGAACGAGGCTGTGGGGGCCCTGATGTACCACACCATCACTCTCACCAGGGAAGACCTGGAGAA	Seq Length=151

ATCCGCGGGGAGACCTTGGGCATCATCGGACTTGGTCGCGTGGGGCAGGCAGTGGCGCTGCGGGCCAAGGCCTTCGGCTTCAACGTGCTCTTCTACGACCCTTACTTGTCGGATGGCGTGGAGCGGGCGCTGGNNCTGCAGCGTGTCAGCA	Seq Length=151

ATGGCTGGAGGCTATCCAGCGTACTCCAAAGATTCAGGTTTACTCACGTCATCCAGCAGAGAATGGA	Seq Length=67

GTACCTNGGGCCACCTGGCTGCACCAGGCGCTGCGGGAGNNCACACNNGTCCAGAGCGTCGAGCAGATCCGCGAGGTGGCGTCCGGCGCTGCCAGGATCCGCGGGGAGACCTTGGGCATNATCGGACTTGGTCGCNNGGTGCAGGCAGNGG	Seq Length=151

GCGGGCCGAGATGTCTCGCTCCGTGGCCTTAGCTGTGCTCGCGCTACTCTCTCTTTCTGGCCTGGAGGCTATCCAGCGTACTGCAAAGATTCAGGTTTACTCACGTCATCCAGCAGAGAATGGAAGATCGGAANNGCACACGTCTGAACA	Seq Length=150

GGGGCATTCCTGAAGCTGACAGCATTCGGGCCGAGATGTCTCGCTCCGTGGCCTTAGCTGTGCTCGCGCTACTCTCTCTTTCTGGCCTGGAGGCTATCCAGCGTACTCCAAAGATTCAGGTTTACTCACGCCATCCAGCAGAGAATGGAAG	Seq Length=151

GGGGCATTCCTGAAGCTGACAGCATTAGGGCCGAGATGTCTCGCTCCGTGGACTTAGCTGTGCTCGCGCTACTCTCTCTTTCTGGCCTGGAGGCTATCCAGCGTACTCCAAAGATTCAGGTTTACTCACGTCATCCAGCAGAGAATGGAAG	Seq Length=151

GGGCATTCCTGAAGCTGACAGCATTCGGGCCGAGATGTCTCGCTCCGTGGCCTTAGCTGTGCTCGCGCTACTCTCTCTTTCTGGCCTGGAGGCTATCCAGCGTACTCCAAAGATTCAGGTTTACTCACGTCATCCAGCAGAGAATGGA	Seq Length=148

TGGGTTGCAAATATTCAAACGAGAACTTTGAAGGCCGAAGTGAAGAAGGGTTCCACAGACCAGGAGAAGATTGAATTCCTG	Seq Length=81

GACGGGCAGAGATGACTAGATCCGTAGACTTAGCTGTGATCGCGCTACTCTCTCTTTCTGGCCTGGAGGCTATCCAGCGTACTCCAAAGATTCAGGTTTACTCACGTCATCCAGCAGAGAATGGA	Seq Length=125

GAGCACAACCACCACCTCATCAACGACTTCACCGTCAAGCAGATGAGACAAGGGGCCTTCCTGGTGAACACAGCCCG	Seq Length=77

CTTCAGGCCTGGAGGCTACCCAGCGTACTCCAAAGATTCAGGTTTACTCACGTCATCCAGCAGAGAATGGA	Seq Length=71

NCCCCATCTGCTGACGCCCCCATGTTNNNCATGGGTGTGAACCA	Seq Length=44

NCCTTACTTGTCGGATGGCGTGGAGCGNGCGCTGGGGCTGCAGCGTGTCAGCACCCTGCAGGACCTGCTCTTCCACAGCGACTGCGTGACCCTGCACTGCGGCCTCAACGAGCACAACCACCACCTCATCAACGACTTCACCGTCAAGCAG	Seq Length=151

TTATTGACGGATGGCGTGGAGCGGGCGCTGGGGCTGCAGCGTGTCAGCACCCTGCAGGACCTGCTCTTCCACAGCGACTGCGTGACCCTGCACTGCGGCCTCAACGAGCACAACCACCACCTCATCAACGACTTCACCGTCAAGCAGATGA	Seq Length=151

NATTTGCAGGGGGGAGCCAAAAGGGTCATCATCTCTGCCCCCTCTGCTGATGCCCCCATGTTCGTCATGGGTGTGAACCA	Seq Length=80

CACGCTCCCGCCGTCTCTCAGGACCGACTGACCATGTTCAACTGCTGTTCACATGGAACCCTTCTCCACTTCGGCCTTCAAAGCTCTCGTTTGAATATTTGCTACTACCACCAAGACCTGCCCCGACGGAGGAAGAGCACACGTCTGAA	Seq Length=149

GGTCATTCCTGAAGCTGACGGCATTCGGGCCGAGATGTCTCGCTCCGTGGCCTTAGCTGTGCTCGCGCTACTCTCTCTTTCTGGCCTGGAGGCTATCCAGCGTACTCCAAAGATTCAGGTTTACTCACGTCATCCAGCAGAGAATGGA	Seq Length=148

GGGCATTCCTGAAGCTGACAGCATTCGGGCCGAGATGTCTCGCTCCGTGGCCTTAGCTGTGCTCGCGCTACTCTCTCTTTCTGGCCTGGAGGCTATCCAGCGTACTCCAAAGATTCAGGTTTACTCACGTCATCCAGCAGAGAATGGA	Seq Length=148

TACGTGGCCTTAGCTGTGCTCGCGCTACTCTCTCTTTCTGGCCTGGAGGCTATCCAGCGTACTCCAAAGATTCAGGTTTACTCACGTCATCCAGCAGAGAATGGA	Seq Length=105

TATATGGTGTTTCCCTACTCAGGCCTCCGGTTGCTCCTCCCTAGAGGGGCAGGATCTGCCTAGGAGGTGGTGGGGGCGTGTNGCGGGGCTCCCACATGNNTGACAGCCTGCTGTGTGTNNNGTGCAGGGANCACCNNGAACTTCTCNNN	Seq Length=149

ATCGACCCTTACTTGTCGGATGGCGTGGAGCGGGCGCTGGGGATGCAGCGTGTCAGCACCCTGCAGGACCTGCTCTTCCACAGCGACTGCGTGACCCTGCACTGCGGCCTCAACGAGCACAACCACCAACTCATCAACGACTTCACCGTCA	Seq Length=151

TTCTGCCTGGAGGCTATCCAGCGTACTCCAAAGATTCAGGTTTACTCACGTCATCCAGCAGAGAATG	Seq Length=67

AGCTACTCCAAAGATTCAGGTTTACTCACGTCATCCAGCAGAGAATGGA	Seq Length=49

GCACCGTCAAGGCTGAGAACGGGAAGCTTGTCATCAATGGAAATCCCATCACCATCTTCCAGGAGCGAGATCCCTCCAAAATCAAGTGGGGCGATGCTGGCGCTGAGTACGTCGTGGAGTCCACTGGCGTCTTCACCACCATGGAGAAGG	Seq Length=150

GCATTCCAGAAGCTGACAGCATTCGGGCCGAGATGTCTCGCTCCGTGGCCTTAGCTGTGCTCGCGCTACTCTCTCTTTCTGNCCTGGAGGCTATCCANNNTACTCCAAAGNTTNAGGTNNNCTCACGNCANCCCANNAGAGAATGGNNNAT	Seq Length=151

TTCTGGACTGGAGGCTATCCAGCGTACTCCAAAGATTCAGGTTTACTCACGTCATCCAGCAGAGAATGGA	Seq Length=70

TGGCCTTAGCTGTGCTCGCGCTACTCTCTCTTTCTGGACTGGAGGCTATCCAGCGTACTCCAAAGATTCAGGTGTACTCAAGTAATCCAGCAGAGAATGGAAGATAGGAAGAGCAAAGGTCTGAAATACAGACACGAGGTTAAATCGTATG	Seq Length=151

NTACTCCAAAGATTCAGGTTTACTCACNNCATCCAGCAGAGAATGGA	Seq Length=47

GGGGCATTCCTGAAGCTGACAGCATTCGGGCCGAGATGTCTCGCTCCGTGGAATTAGCTGTGCTCGCGCGACTCTCGCGTTCTGGGGTGGAGGCTATCCAGCGTACTCCAAAGATTCAGGTTTACTCACGTCATCCAGCAGAGAATGGNAG	Seq Length=151

GGGGCATTCCTGAAGCTGACAGCATTCGGGCCGAGATGTCTCGCTCCGTGGACTTAGCTGTGCTCGCGTGACTCTCGCGTTCTGGGCTGGAGGCTATCCAGCGCACTCCAAAGATTCAGGTTTACTCACGTCATCCAGCAGAGAATGGAAG	Seq Length=151

TTCTCGCCTGGAGGCTATCCAGCGTACTCCAAAGATTCAGGTTTACTCACGTCATCCAGNAGAGAATGGA	Seq Length=70

GAATTAATGAAGCTGACAGAATTCGGGCCGAGATGTCTCGCTCCGTGGCCTTAGCTGTGATAGCGCTACTCTATCTTTCTGGCCTGGAGGCTGTCCAGCGTACTCCAAAGATTCAGGTTTACTCACGTCATCCAGCAGAGAATGGA	Seq Length=146

CAAAAGGGTCATCATCTCTGCCCCCTCTGCTGATGCCCCCATGTTCGTCATGGGTGTGAACCA	Seq Length=63

NTGCCCCCTCTGCTGACGCCCCCATGTNNGTCATGGGTGTGAACCA	Seq Length=46

TTCTGGAAAGGAGGCTATCCAGCGTACTCCAAAGATTCAGGTTTACTCACGGAATAAAGAAGAGAATGGCAGATAGGAAGAGCACACGGATGACATCCAGTCACGTGTTTATCTCGTATGCCGTCTTCTGCTTGAAAAAAAAAAAAAAAAA	Seq Length=151

CTTTATGGTCTGGAGGCTATCCAGCGTACTCCAAAGATTCAGGTTTACTCACGTCATCCAGCAGAGAATGGA	Seq Length=72

CTTTATGGTCTGGAGGCTATCCAGCGTACTCCAAAGATTCAGGTTTACTCACGTCATCCAGCAGAGAATGGA	Seq Length=72

ATGATTGACAGATTGATAGCTCTTTCTCGATTCCGTGGGTGGTGGTGCATGGCCGTTCTTAGTTGGTGGATGAGAAGGCGC	Seq Length=81

NATTCCTGAAGCTGACAGCATTCGGGNNNAGATGTCTCGCTCCGTGGCCTTAGCTGTGCTCGCGCTACTCTCTCTTTCTGGCCTGGAGGCTATCCAGCGTACTCCAAAGATTCAGGTTTACTCACGTCATCCAGCAGAGAATGGA	Seq Length=145

CTGTGCTCGCGCTACTCTCTCTTTCTGGCCTGGAGGCTATCCAGCGTACTCAAAAGATTCAGGTTTACTCACGTCATCCAGCAGAGAATGGA	Seq Length=92

TTATGGCTGGAGGCTATCCAGCGTACTCCAAAGATTCAGGTTTACTCACGTCATCCAGCAGAGAATGGA	Seq Length=69

CTATTGACAGATGGCGTGGAGCGGGCGCTGGGGCTGCAGCGTGTCAGCACCCTGCAGGACCTGCTCTTCCACAGCGACTGNNGGACCCTGCACTGCGNNNACAACGAGCACNACCACCNNNTCATCAANGNCATANNCGGCAAGCANNNAA	Seq Length=151

GCATTTCTGAAGCTGACAGCATTCGGGACGAGATGTCTCGCTCCGTGGCCTTAGCTGTGCTCGCGCTACTCTCCCTTTCTGGCCTGGAGGCTATCCAGCGTACTCCAAAGATTCAGGTTTACTCACGTCATCCNGCAGAGAATGGA	Seq Length=146

TTCTGGCCTGGAGGCTATCCAGCGTACTACAAAGATTCAGGTTTACTCACGTCATCCAGCAGAGAATGGA	Seq Length=70

TTACTTGTCGGATGGCGTGGAGCGGGCGCTGGGGCTGCAGCGTGTCAGCACCCTGCAGGACCTGCTCTTCCACAGCAACTGCGTGACCCTGCACTGCGGCCTCAGCGAGCACAACCACCACCTCATCAACGACTTCACCGTCAAGCAGATG	Seq Length=151

NTGCACTAGTTGGCTTCTGACAAATGGAAAGTCCTGACACACTTGTGATTTACTGGGATATCCTGTGGCACCTCTCCAAGTTGGTGGTCTGCCCAGACACTCATTGCTGTGGTGATGCCAACACTCTACCATTTTCCAGCGTGGAAATACA	Seq Length=151

GGGGCATTCATGAAGCTGACAGCATTCGGGCAGAGATGTCTCGCTCCGTGGCCTTAGCTGTGCTCGCGCTACTATCTCTTTCTGGCCTGGAGGCTATCCAGCGTACTCCAAAGATTCAGGTTTACTCACGTCATCCAGCAGAGAATGGAAA	Seq Length=151

ACCTTAGCTGTGCTCGCGCTACTCTCTCTTTCTGGCCTGGAGGCTATCCAGCCTACTCCAAAGATTCAGGTTTACTCACGTCATCCAGCAGAGAATGGA	Seq Length=99

CACACCCACCACCCCATCAACGACTTCACCGTCAAGCAGATGAGACAAGGGGCCTTCCTGGTGAACACAGCCCG	Seq Length=74

CGTACTAAAAAGATTCAGGTTTACTCACGTATCCAGCAGAGAATGTA	Seq Length=47

CTCTGCCCCCTCTGCTGACGCCCCCATGTTCGTCATGGGTGTGAACCAAGATNGGAAGANNACACGTCTGNACTCCAGTCACGTGTNTATATCGTATGCCGTCTNNTGCTTGAAAANAAAAAAAAAAAAAAATAAATGAAAAAAAAACAAA	Seq Length=151

AAACTAAGTGGGGCGATGCTGGCGCTGAGTACGTCGTGGAGTCCACTGGCGTCTTCACCACCATGGAGAAGGCTGGGGCTCATTTGCAGGGGGGAGCCAAAAGGGTCATCATCTCTGCCCCCTCTGCTGATGCACCAATGTTCGTCATGGG	Seq Length=151

CTTTCTGGCCTGGAGGCTATCCAGCGTACTCCAAAGATTCAGGTTTACTCACGTCATCCAGCAGAGAATGGA	Seq Length=72

CACTTTCTGGCCTGGAGGCTATCCAGCGTACTCGAAAGATTCAGGTTTACTCACGTCATNCAGCAGAGAANGGA	Seq Length=74

GGACCGCGGCGTCTGTGGAGGAGACGGCCGACTCGACGCTGTGCCACATCCTGAACCTGTACCGGCGGACCAACTGGCTGCAACAAGGGCGACGGGAGGGAACACAAGTCCAAAGCGTCGAACAGAACCGCGAGGTGTCGTCCGGCGCTAG	Seq Length=151

CGTATGTGGAGGAGACGGCCGACTAGACGCTGTGCCACATCCTGAAACTGTACAGGAGGGACAAAAGGCTGCAACAAGCGCAGCGGGAAGGAAAAAGAATACAGAAAGTCGAGAAAAAACACGAAGGGGGAGCCGGCGCTGACAGGAACCG	Seq Length=151

CCTGACCTGGAGGCTATCCAGCGTACTCCAAAGATTCAGGTTTACTCACGTCATCCAGCAGAGAATGGA	Seq Length=69

GATTCCTGGAGCTGACAGCATTCGGGCCGAGATGTCTCGCTCCGTGGCCTTAGCTGTGCTCGCGCTACTCTCTCTTTCTGGCCTGGAGGCTATCCAGCGTACTCCAAAGATTCAGGTTTACTCACGTCATCCAGCAGAGAATGGA	Seq Length=145

GAACTGGCCTGGAGGCTATCCAGCGTACTCCAAAGATTCAGGTTTACTCACGTCATCCAGCAGAGAATGGA	Seq Length=71

CCCATCACCATCTTCCAGGAGCGAGATCCCTCCAAAATCAAGTGGGGCGATGCTGGCGCTGAGTACGTCGTGGAGTCCACNGGCGTCTTCACCACCATGGAGAAGGCTGGGNCTCATTTNCAGGGGGGAGCCAAANNGGTCATCATCTNTG	Seq Length=151

AACTTCAACTACATGGTTTACATGTTCCAATATGATTCCACCCATGGCAAATTCCATGGCACCGTCAAGGCTGAGAACGGGAAGCTTGTCATCAATGGAAATCCCATCACCATCTTCANNNAGCGAGATCCCTCCAAAATCAAGTGGGNCG	Seq Length=151

GGCTTTCTAGGCGGGTGTCCCCTTCCTCCCTCACCGCTCCATGTGCGTCCCTCCCGAAGCTGCGCGCTCGGTCGAAGAGGACGACCATCCCCGATAGAGGAGGACCGGTCTTCGGTCAAGGGTATACGAGTANNTGCGCTCCCCTGCTATG	Seq Length=151

GTGGCATTCGGGCCGAGATGTCTCGCTCCGTGGCCTTAGCTGTGCTCGCGCTACTCTCTCTTTCTGGCCTGGAGGCTATCCAGCGTACTCCAAAGATTCAGGTTTACTCACGTCATCCAGCATAGAATGGA	Seq Length=131

GTGGCATTCGGGCCGAGATGTCTCGCTCCGTGGCCTTAGCTGTGCTCGCGCTACTCTCTCTTTCTGGCCTGGAGGCTATCCAGCGTACTCCAAAGATTCAGGTTTACTCACGTCATCCAGCAGAGAATGGA	Seq Length=131

CTTCAAAATCAAGTGGGGCGATGCTGGCGCTGAGTACGTCGTGGAGTCCACTGGCGTCTTCACCACCATGGAGAAGGCTGGGGCTCATTTGCAGGGGGGAGCCAAAAGGGTCATCATCTCTGCCCCCTCTGCNGNCGCCCCCATGTTCGT	Seq Length=150

CCGAGCCCTCTGCTGACGCACCCATGTTCGTCATGGGTGTGAACCA	Seq Length=46

CCTTTCGGCCTGGAGGCTATCCAGCGTACTCCAAAGATTNNGGTTTNNTCACGTCATCCAGCAGAGAATGGA	Seq Length=72

TTTTCAGGCCTGGAGGCTATCCAGCGAACTCCACAGATTAAGGTTTACTCACGTCATCCAGCAGAGAATGGA	Seq Length=72

CACCTGGTATGACAACGAATTTGGCTACAGCAACAGGGTGGTGGACCTCATGGCCCACATGGCCTCCAAGGAGTAAGACCCCTGGACCACCAGAAATCCCATCACCATCTTCCAGGAGCGAGATCCCTCCAAAATCAAGAGGGGCGATG	Seq Length=149

CACCTGGTATGACAACGAATTTGGCTACAGCAACAGGGTGGTGGACCTCATGGCCCACATGGCCTCCAAGGAGTAAGACCCCTGGACCACCAGAAATCCCATCACCATCTTCCAGGAGCGAGATCCCTCCAAAATCAAGTGGGGCGATG	Seq Length=149

CACCTGGTATGACAACGAATTTGGCTACAGCAACAGGGTGGTGGACCTCATGGCCCACATGGCCTCCAAGGAGTAAGACCCCTGGACCACCAGAAATCCCATCACCATCTTCCAGGAGCGAGATCCCTCCAAAATCAAGTGGGGCGATG	Seq Length=149

AAAAAAAAAAGAGGGGCGAAGCTGGCGATGAGTACGTCGTGGAGTCCACTGGCGTCTTCACCACCATGGAGAAGGCTGGGGCTCATTTGCAGGGGGGAGCCAAAAGGGTCATTATCTCTGCCCCCTCTGCTGACGCCCCCATGTTCGTCAT	Seq Length=151

AAAAAAAAAAGAGGGTCGAAGCTGGCGAAGAGTACGTCGTGGAGTCGACTGGCGTCTTCACCACCATGGAGAAGGCTGGGGCTCATTTGCAGGGGGGAGCCAAAAGGGTCATTATCTCTNCCCCCTCTGCTGACGCCCCCATGTTCGTCAT	Seq Length=151

GTGGTTCCTTTGGTCGCTCGCTCCTCTCCTACTTGGATAACTGTGGTAATTCTAGAGCTAATACATGCCGACGGGCGCTGACCCCCTTCGCGGGGGGGATGCGTGCATTTATCAGATCAAAACCAACCCGGTNNGCCCCTNNCCGGCCCCN	Seq Length=151

GGGCATTGCTGAAGCTGACAGCATTCGNGCCGAGATGTCTCGCTCCGTGGCCTTAGCTGTGCTCGCGCTACTCTCTCTTTCTGGCCTGGAGGCTATCCAGCGTACTCCAAAGATTCAGGTTTACTCACGTCATCCAGCAGAGAATGGA	Seq Length=148

NGCAAATAAGACAAGGGGCCTTCCTGGTGAACACAGCCCG	Seq Length=40

TTCTGCCCTGGAGGCTATCCAGCGTACTCCAAAGATTCAGGTTTACTCACGTCATCCAGCAGAGAATGGA	Seq Length=70

TGTGCCTCTTTGTATGAATCACTAACCTCACTGTACCTTAGCTGTAACATCTGTTAAATGAGGAAATCAGGCTAGAAATTTTGAACTCCACCCCACCCTGCCCTTTCTTCTAATGAAATNTTACTTGAAGCATGAACAAAAAAATTACNGG	Seq Length=151

ACAGTACAGTGGGAGAAAGCTGAAGATAATGGATGTAGAATTACATACTATATCCTTGAGATAAGAAAGAGCACTTCAAATAATTAACAGAACCAGAATTTAAGGTAGAAGATG	Seq Length=114

AGCTGGCCTGGAGGCTATCCAGCGTACTCCAAAGATTCAGGTTTACTCACGTCATCCAGCAGAGAATGGA	Seq Length=70

CACGCTTACTTGTCGGATGGCGTGGAGCGGGCGCTGGGGCTGCAGCGTGTCAGCACCCTGCAGGACCTGCTCTTCCACAGCGACTGCGTGACCCTGCACTGCGGCCTCAACGAGCACAACCACCACCTCATCAACGACCTCACCGTCAAG	Seq Length=150

GGGCATTACTGAAGCTGACATCATTCGGGCCGAGATGTCTCGCTCCGTGGCCTTAGCTGTGCTCGCGCTACTCTCTCTTTCNNGCCTGGAGGCTATCCNGCGTACTCCAAAGATTCAGNNNTACTCNCGTCATCNAGNAGAGAATNNNNAA	Seq Length=151

TTCTGGCCTGGAGGCTATCCAGCGTACTCCAAAGATTCAGGTTTACTCACGTCATCCAGCAGAGAATGGA	Seq Length=70

GGGCATTTCTGAAGCTGACAGCATTCGGGCCGAGATGTCTCGCTCCGTGGCCTTAGCTGTGCTCGCGCTACTCTCTCTTTCTGGCCTGGAGGCTATCCAGCGTACTCCAAAGATTCAGGTTTACTCACGTCATCCAGCAGAGAATGGA	Seq Length=148

CTGCCCCCTCTGCTGATGCCCCCATGTTCGTCATGGGTGTGAACCA	Seq Length=46

NCAAATTCAAGTGGGGCGATGCTGGCGCTGAGTACGTCGTTTATTCCACTTTCGTCTTCACCACCATGTATAAGGCTGGGGCTCATTTTCATTGTGGAGCCACAAGGGTCATCATCTCTGCCCCCTCTGCTGACGCCCCCATGTTCGTCAT	Seq Length=151

NCAAATTCAAGTGGGGCGATGCTGGCGCTGAGTACGTCGTGGAGTCCACTGTCGTCTTCACCACCATGGATAATTCTGGGGCTCATTTTCAGGGGGGAGCCAAAAGGGTCATCATCTCTGCCCCCTCTGCTGACGCCCCCATGTTCGTCAT	Seq Length=151

CCAAAGATTCAGGTTTACTCACGTCATCCAGCAGAGAATGGA	Seq Length=42

CGACCCTGCACTGCGGCCTCAACGAGCACAACCACCACCTCATCAACGACTTCACCGTCAAGCAGATGAGACAAGGGGCCTTCCTGGTGAACACAGCCCG	Seq Length=100

TTCTGGCTGGAGGCTATCCAGCGTACTCCAAAGATTCAGGTTTACTCACGTCATCCAGCAGAGAATGGA	Seq Length=69

TTTCTAGGCCTGGAGGCTATCCAGCGTACTCCAAAGATTCAGGTTTACTCACGTCATCCAGAAGAGAATGGA	Seq Length=72

CAAATGGGGCGATGATGGCGCTGAGTACGTCGTGGAGTCCACAGGCGTCTTCACCACCATGGAGAAGGCTGGGGCTCATTTGCAGGGGGGAGCCAAAAGGGTCATTATCTCTGCCCCCTCTGCTGATGCCCCCATGTTCGTCATGGGTGTG	Seq Length=151

GGGGCATTCCTGAAGCTGACAGCATTCGGGCCGAGATGTCTCGCTCCGTGGCCTTAGCTGTGCTCGCGCTACTCTCTCTTTCTGGCCTGGAGGCTATCAAGCGTACTCCAAAGATTCAGGTTTACTCACGTCATCCAGCANNGNATGGAAA	Seq Length=151

NTTCTGGCCTGGAGGCTATCCAGCGTACTCCAAAGATTCAGGTTTACTCACGTCATCCAGCAGAGAATGGA	Seq Length=71

TTGCATTCCTGAAGCTGACAGCATTCGGGCCGAGATGTCTCGCTCCGTGGCCTTAGCTGTGCTCGCGCTACTCTCTCTTTCTGGCCTGGAGGCTATCCAGCGTACTCCAAAGATTAAGGTTTACTCACGTCAGACAGAAGAGAATGGA	Seq Length=148

NTCTATTCTGGGGGCTATCCAGCGTACNCCAAAGATTCAGGTTTACTCACGTCATCCAGCAGAGAATGGA	Seq Length=70

CCAGGGGGCATTCCTGAAGCTGACAGCATTCGGGCCGAGATGTATCGCTACGTGGAATTAGCTGTGCTCGCGCTACTCTCTATTTATGGCCTGGAGGATATCCAGCGTACTCCAAAGATTCAGGTTTACTCACGTCATCCAGCAGAGAATG	Seq Length=151

TTCTGGCCTGGAGGCTATCCAGCGTACTCCAAAGATTCAGGTTTACTCACGTCATCCAGCAGAGAATGGA	Seq Length=70

TTCTGGGCTGGAGGCTATCCAGCGTACTCCAAAGATTCAGGTTTACTCACGTCATCCAGCAGAGAATGGA	Seq Length=70

GTGCTCCAGAGATTCAGGTTTACTCACGTCATCCAGCAGAGAATGGA	Seq Length=47

NGGCATTCCTGAAGCTGACAGCATTCGGGCCGAGATGTCTCGCTCCGTGGCCTTAGCTGTGCTCGCGCTACTCTCTCTTTCTGGCCTGGAGGCTATCCAGCGTACCCCAAAGATTCAGGTTTACTCACGTCATCCAGCAGAGAATGGA	Seq Length=148

CTACTGGCCTGGAGGCTATCCAGCGTACTCCAAAGATTCAGGTTTACTCACGTCATCCAGCAGAGAATGGA	Seq Length=71

AGACCTGGGGCCTTCCTGGTGAACACAGCCCG	Seq Length=32

CTGGCCTGGAGGCTATCCAGCGTACTCCAAAGATTCAGGTTTACTCACGTCATCCAGCANAGAATGGA	Seq Length=68

CATCCTGGCCTGGAGGCTATCCAGCGTACTCCAAAGGTTCNGGTTTNCTCACGTCATCCAGAAGAGAATGGA	Seq Length=72

TAACTTTCGGATGGCGTGGAGCGGGCGCTGGGGCTGCAGCGTGTCAGCACCCTGCAGGACCTGCTCTTCCACAGCGACTGCGTGACCCTGCACTGCGGCCTCAACGAGCACAACCACCACCTCATCAACGACTTCACCGTCAAGCAGATGA	Seq Length=151

NGGGCATTCCTGAAGCTGACAGCATTCGGGCCGAGATGTCTCGCTCCGTGGCCTTAGCTGTGCTCGCGCTACTCTCTCTTTCTGGCCTGGAGGCTATCCAGCGTACTCCAAAGATTCAGGTTTACTCGCGTCATCCAGCAGAGAATGGAAG	Seq Length=151

GATTCCTGGAGCTGACAGCATTCGGGCCGAGATGTCTCGCTCCGTGGCCTTAGCTGTGCTCGCGCTACTCTCTCTTTCTGNCCTGGAGGCTATCCAGCGTACTCCAAAGATNCAGGTTTNCTCACGTCATCCAGCNNAGAATGGA	Seq Length=145

ACCGATTGCGTGACCCTGCACTGCGGCCTCAACTAGCACAACCACCACCTCATCAACGACTTCACCGTCAAGCAGATGAGACAAGTGTCCTTCCTGGTGAACACAGCCCG	Seq Length=110

CCTAAGCTGTGCTCGCGCTACTCTCTCTTTCTGGCCTGGAGGCTATCCAGCGTACTCCAAAGATTCAGGTTTACTCACGTCATCCAGCAGAGAATGGA	Seq Length=98

TCTGGCATGGAGGCTATCCAGCGGACTACAAAGATTCAGGTTTACTCACGTCATCCAGCAGAGAATGGA	Seq Length=69

ATCCCTTACTTGTCGGATGGCGTGGAGCGGGCGCTGGGGCTGCAGCGTGTCAGCACCCTGCAGGACCTGCTCTTCCACAGCGACTGCGTGACCCTGCACTGCGGCCTCAACGAGCACAACCACCACCTCATCAACGACTTCACCGTCAAG	Seq Length=150

TGGCGTCTTCACCACCATGGAGAAGGCTGGGGCTCATTTGCAGGGGGGAGCCAAAAGGGTCATCATCTCTGCCCCCTCTGCTGATGCCCCCATGTTCGTCATGGGTGTGAACCA	Seq Length=114

CTGGAGGCTATCCAGCGTACTCCAAAGATTCAGGTTTACTCACGTCATCCAGCAGAGAATGGA	Seq Length=63

NAATTCAGGTTTACTCACGTCATCCAGCAGAGAATGGA	Seq Length=38

TTCTGGCCTGGAGGCTATCCAGCGTACTCCAAAGATTCAGGTTTACTCACGTCATCCAGCAGAGAATGGA	Seq Length=70

GGTTGACTCACGTCATCCAGCAGAGAATGGA	Seq Length=31

ACTGGCCTGGAGGCTATCCAGCGTACTCCAAAGATTAAGGTTTACTCACGTCATCCAGCAGAGAATGGA	Seq Length=69

TTCTGGCCTGGAGGCTATCCAGCGTACTCCAAAGATTAAGGTTTACTCACGTCATCCAGCAGAGAATGGA	Seq Length=70

TTCTGGCCTGGAGGCTATCCAGCGTACCCCAAAGATTCAGGTTTACTCACGTCATCCAGCAGAGAATGGA	Seq Length=70

NCCGTACTCCAAAGATTCAGGTTTACTNNCGTCATCCAGCAGAGAATGGA	Seq Length=50

GCGGCCTCAACGAGCACAACCACCACCTCATCAACGACTTCACCGTCAAGCAGATGAGACAAGGGGCCTTCCTGGTGAACACAGCCCG	Seq Length=88

CAGTTACATGGTTTACATGTTCCAATATGATTCCACCCATGGCAAATTCCATGGCACCGTCAAGGCTGAGAACGGGAAGCTCGTCATCAATGGAAATCCCATCACCATCTTCCAGGAGCGAGATCCCTCCAAANTCAAGTGGGGCGATG	Seq Length=149

CAGTTACATGGTTTACATGTTCCAATATGATTCCACCCATGGCAAATTCCATGGCACCGTCAAGGCTGAGAACGGGAAGCTCGTCATCAATGGAAATCCCATCACCATCTTCCAGGAGCGAGATCCCTCCAANNNCAAGTGNGTCGATGCN	Seq Length=151

NGGTATTCCTGAAGCTGACAGCATTCGGGCCGAGATGTCTCGCTCCGTGGCCTTAGCTGTGCTCGCGCTACTCTCTCTTTCTGGCCTGGGGGCTATCAAGCGTACTCCAAAGATTCAGGTTTACTCACGTCATCCAGCAGAGAATGGAAAA	Seq Length=151

GGTCTTGGAGGCTATCCAGAGAAAAGGAAGGATTCAGGTTTACTCACGTCATCCAGCAGNGAATGGA	Seq Length=67

AAAAAAAAAAAAAAGGAAAAGAGAATAAGAAAGAAGAAAAAGTAAAAATAAAAAGAGAAAAAAAAAAAAAACAAAAAAAAAATGAAAAGAAAGAAAAAAACAAAACAAAAAAAAAAAAAGAAAAAAAAAAAAAAAAAAAAAAAAAAAGAA	Seq Length=150

NCCGGCTTCAACGTGCTCTTCTACGACCCTTACTTGTCGGATGGCGTGGAGCGGGCGCTGGGGCTGCAGCGTGTCAGCACCCTGCAGGACCTGCTCTTCCACAGCGACTGCGTGACCCTGCACTGCGGCCTCAACGAGCACAACCACCAC	Seq Length=150

NGATCCCACCAAAATCAAGTGGGGCGANGCTGGCGCTGAGTACGTCGTGGGGTCCACTGGCGTCTTCACCACCATGGAGAAGGCTGGGGCTCATTTGCAGGGGGGAGCCAAAAGGGTCATCATCTCTGCCCCCTCTGCTGACGCCCCCATG	Seq Length=151

GGGCATTCCTGAAGCTGACAGCATTCGGGCCGAGATGTCTCGCTCCGTGGCCTTAGCTGTGCTCGCGCTACTCTCTCTTTCTGGCCTGGAGGCTATCCAGCGCACTCCAAAGATTCAGGTTTACTCACGTCATCCAGCAGAGAATGGA	Seq Length=148

TTCTGGCCTGGAGGCTATCCAGCGTANNNCAAAGATTCAGGTTTACTCACGTCATCCAGCAGAGAATGGA	Seq Length=70

ACTTGCCTCTGGCCAAGACAAACCTCACATGGTATGGCATCACCAGCCCTACTCCAACATACCTGGTTTATTATGCAGAAGTTAATGACAGGAAAAACAGCTCTGACTTGAAATATAAAATTCTAGAATTTCAGGACAGTATAGCTCTTAT	Seq Length=151

NCTTGCCTCTGGCCAAGACAAACCTCACATGGTATGGCATCACCAGCCCTACTCCAACATACCTGGTTTATTATGCAGAAGTTAATGACAGGAAAAACAGCTCTGACTTGAAATATAGAATTCTGGAATTTCAGGACAGTATAGCTCTTAT	Seq Length=151

ACATGACTCTGGACAAGACAAACCTCACATGATATGGAATCACCAGCCCTACTCCAACATAACTGGTTTATTATGCAGAAGTTAATGACAGGAAAAACAGCTCTGACTTGAAATATAGAATTCTGGAATTTCAGGACAGTATAGCTCTTAT	Seq Length=151

GCATTCCTGAAGCTGACAGCATTCGGGCCGAGATGTCTCGCTCCGTGGCCTTAGCTGTGCTCGCGCTACTCTCTCTTTCTGGCCTGGAGGCTATCCAGCGTACTCCAAAGATTCAGGTTTACTCACGTCATCCAGCAGAGAATGGA	Seq Length=146

GGCGACTACAAAGATTCAGGTTTACTCACGTCATNCAGCAGAGNATGGA	Seq Length=49

GGCACTCCAGAAGCTGACAGCATTCGGGCCGAGATGTCTCNCTCCGNGGCCTTAGCTGTGCTCGCGCTACTCTCTCTTTCTGGCCTGTAGGCTATCCAGCGTACTACAAAGATTCAGGTNTACTCACGTCATCCAGCAGAGAATGGA	Seq Length=147

TAAGTGGAAATCTTAGGAGTTGGAAGAGGAGAAATCAAAGTAGCAGTGAAGACTTTGAAAAAGGGTTCCACAGACCAGGAGAAGATTGAATTCCTG	Seq Length=96

TTCTCGGCCTGGAGGCTATCCAGCGTACTCCAAAGATTCAGGTTTACTCACGTCATCCAGCAGAGAATGGA	Seq Length=71

TATTTGTCGGATGGCGTGGAGCGGGCGCTGGGGCTGCAGCGTGTCAGCACCCTGCAGGACCTGCTCTTCCACAGCGACTGCGTGACCCTGCACTGCGGCCTCAACGAGCACAACCACCAACTCATCAACGACTTCACCGTCAAGCAGATGA	Seq Length=151

TTCTGGCCTGGAGGCTATCAAGAGTACTACAAAGATTCAGGTTTACTCACGTCATCCAGCAGAGAATGGA	Seq Length=70

GGTTTACTCACGTCATCCAGCAGAGAATGGA	Seq Length=31

NATCAGGTGGGGCGATGCTGGCGCTGAGTACGTCGTGGAGTCCACTGGCGTCTTCACCACCATGGAGAAGGCTGGGGATCATTTGAAGGGGGGAGCCACGAGGGTAATCAGATGTGCCCCCGCTGCTGATGCCCCCATGTTCGTCATGGGT	Seq Length=151

TTCTGGCCTGGAGGCTATCCAGCGTACTCCAAAGATTGAGGTTTACTCACGTCATCCAGCAGAGAATGGA	Seq Length=70

TACTCGTTGGATGGCGTGGAGCGGGCGCTGGGGCTGCAGCGTGTCAGCACCCTGCAGGACCTGCTCTTCCACAGCGACTGCGTGACCCTGCACTACGGCCTCAACGAGCACAACCACCACCTCATCAACGACNNAACCGTCAAGCAGATGN	Seq Length=151

CAAAATCAGGTGGGGCGATGCTGGCGCTGAGTACGTCGTGGAGTCCACTGGCGTCTTCACCACCATGGAGAAGGCTGGGGCTCATTTGCAGGGGGGAGCCAAAAGGGTCATCATCTNTGCCCCCNCTGCTGATGCCCCAANNTNAGTCATG	Seq Length=151

GAGGGTAGTATATTCTTAAGTGGCGCAAGCACAGCCAAATCGCTGAGACACCCTCTTTAAAGTGAATATCTTAGTGAAAGGAAAGGGTAGTATGGAGCGGCTGGTCAGCAGGGCGGGTTATAACTCTGGTAAAGTGGATATGGTTGCAAT	Seq Length=150

CCTACGACCCTTACTTGTCGGATGGCGTGGAGCGGGCGCTGGGGCTGCAGCGTGTCAGCACCCTGCAGGACCTGCTCTTCCACAGCGACTGCGTGACCCTGCACTGCGGCCTCAACGAGCACAACCACCACCTCATCAACGACTTCACCGT	Seq Length=151

CGGGGCATTCCTGAAGCTGACAGCATTCGGGCCGAGATGTCTCGCTCCGTGGCCTTAGCTGTGCTCGCGCTACTCTCTCTTTCTGGCCTGGAGGCTATCCAGCGTACTCCAAAGATTCAGGTTTACTCACGTCATCCAGCAGAGAATGGAA	Seq Length=151

NGATTCCTGAAGCTGACAGCATTCGGGCCGAGATATCTAGCTACGTGGACTTAGATGAGCTCGCACTAATCTCACTTTCTAGCATGGAAGCTATCCAGCGTACTCAAAAGATTAAGGTTTACTCACGTCATCGAGCAGAGAATGGA	Seq Length=146

GGGGCATTCCTGAAGCTGACAGCATTCGGGCCGAGATGTCTCGCTCCGTGGCCTTAGCTGTGCTCGCGCTACTCTCTCTTTCTGGCCTGGAGGCTATCCAGCGTACTCCAAAGATTCAGGTTTACTCACGTCATCCAGCAGAGAATGGAAG	Seq Length=151

TCCGCTCCGTGGCCTTAGCTGTGCTCGCGCTACTCTCTCTTTCTGGCCTGGAGGCTATCCAGCGTACTCCAAAGATTCAGGTTTACTCACGTCATCCAGCAGAGAATGGA	Seq Length=110

AGCCAAGAGGGTCATCATCTCTGCCCCCTCTGCTGATGCCCCAATGTTCGTCATGGGTGNGAACCAAGATCGGAAGAGAACAGGTATGAACTCCAGTCAAGTGTTAGTCTCGTAGGCCGTCAGATGCTTGAAAAGAAGAAACACGAAGAAA	Seq Length=151

NCTTAGCTGTGCTCGCGCTACTCTCTCTTTCTGGCCTGGAGGCTATCCAGTGTACTCCAAAGATTCAGGTTTACTCACGTCATCCAGCAGAGAATGGA	Seq Length=98

CTGCACGCCGGCCTCAACGAGCACAACCACCACCTCATCAACGACTTCACCGTCAAGCANATGAGACAAGGGGCCTTCATGGTGAACACAGCCCG	Seq Length=95

GCAGCTGACAGCATTCGGGCCGAGATGTCTCGCTCCGTGGCCTTAGCTGTGCTCGCGCTACTCTCTCTTTCTGGCCTGGAGGCTATCCAGCGTACTCCAAAGATTCAGGTTTACTCACGTCATCCAGCAGAGAATGGA	Seq Length=138

TGCTTACAGCATTCGGGCCGAGATGTCTCGCTCCGTGGCCTTAGCTGTGCTCGGGCTACTCTCTCTTTCTGGCCTGGAGGCTATCCAGCGTACTCCAAAGATTCAGGTTTACTCACGTCATCCAGCAGAGAATGGA	Seq Length=136

TCGGGCCTAGAGGCTATCCAGCGTACTCCAAAGATTCAGGTTGACTCACGTCATCCAGCNGAGAATGGA	Seq Length=69

NCTAGCCTGGAGGCTATCCAGCGTACTCCAAAGATTCAGGTTTACTCACGTCATCCAGCAGAGAATGGA	Seq Length=69

ATCCTGGCCTGGAGGCTGTCCAGCGTACTCCAAAGATTCAGGTTTACTCACGTCATCCAGCAGAGAATGGA	Seq Length=71

CTGCCCCCTCTGCTGACGCCCCCATGTTCGTCATGGGTGTGAACCA	Seq Length=46

TTATGGCCTGGAGGCTATCCAGCGTACTCCAAAGATTCAGGTTTACTCACGTCATCCAGCAGAGAATGGA	Seq Length=70

NGGGCATTCCTGAAGCTGACAGCATTCNGGCCGAGATTTCTCGCTCCGTGGCCTTAGCTGTGCTCGCGCTACTCTCTCGTTCATGCCTGGAGGCTATCCAGAGTACTATAAAGATTCAGGATTACTAACTTCATCTAGCAGAGAAAGGAAG	Seq Length=151

NTTTCTGGTCTGGAGGCTATCCAGCGTACTCCAAAGATTCAGGTTTACTCACGTCATCCAGCAGAGAATGGA	Seq Length=72

TTCTGGGCTGGAGGCTATCCAGCGTACTCCAAAGATTCAGGTTTACTCACGTCATCCAGCAGAGAATGGA	Seq Length=70

GCTACTCTCTCTTTCTGGCCTGGAGGCTATCCAGCGTACTCCAAAGATTCAGGTTTACTCACGTCATCCAGCAGAGAATGGA	Seq Length=82

CAAGTGGGCGATGCTGGCGCTGAGTACGTCGTGGAGTCCACTGGCGTCTTCACCACCATGGAGAAGGCTGGGGCTCATTTGCAGGGGGGAGCCAAAAGGGTCATCATCTCTGCCCCCTCTGCTGACGCCCCCATGTTCGTCATGGGTGTGA	Seq Length=151

NTTTCTGGCCTGGAGGCTATCCAGCGTACTCCAAAGATTCAGGTTTACTCACGTCATCCAGCAGAGAATGGA	Seq Length=72

GTCGGGCCTGGAGGCTATCCAGCGTACTCCAAAGATTCAGGTTTACTCACGTCATCCAGCAGAGAATGGA	Seq Length=70

GCACTAACCAACCACACCTAGCATTCCTGCACATCTGTACCCACGCCTTCTTCAAAGCCATACTATTTATGTGCTCCGGGTCCATCATCCACAACCTTAACAATGAACAAGATATCCGAAAAATAGGAGGACTACTCAAAACCATACCT	Seq Length=149

NACTGCCTGGAGGCTATCCAGCGTACTCCAAAGATTCAGGTTGACTCACGTCATCCAGCAGAGAATGGA	Seq Length=69

AAAAGGAAGAGGAGAAGAGAAAGAAAAGAAGAGAAAAAGAAAAAAAGGGAAAATGGGAGAGAAAAAAGAAAAAGAGGAAAGAAGAAGAGAAAAGGGAAGAAAAGAAGAGAATAAGAAAAAAAAAAGAAGAAGAGAAAGAAAAAGAAAAAAA	Seq Length=151

TGGGGCATTCCTGAAGCTGACAGCATTCGGGCCGAGATGTCTCGCTCCGTGGCCTTAGCTGTGCTCGCGCTACTCTCTCTTTCTGGCCTGGAGGCTATCCAGCGTACATGAAAGATTCANGTTTACTCACTTCATAAAGCAGAGAACGGAA	Seq Length=151

TCTGCGACCCTTACTTGTCGGATGGCGTGGAGCGGGCGCTGGGGCTGCAGCGTGTCAGCACCCTGCAGGACCTGCTCTTCCACAGCGACTGCGTGACCCTGCACTGCGGCCTCAACGAGCACAACCACCACCTCATCAACGACTTCACCGT	Seq Length=151

NTTTCTGGCCTGGAGGCTATCCAGCGTACTCCAAAGATTCAGGTTTACTCACGTCATCCAGCAGAGAATGGA	Seq Length=72

NATCAGCATTCGGGCCGAGATGTCTCGCTCCGTGGCCTTAGCTGTGCTCGCGCTACTCTCTCTTTCTGGCCTGGAGGCTATCCAGCGTACTCCAAAGATTCAGGTTTACTCACGTCATCCAGCAGAGAATGGA	Seq Length=133

CGTTCTGGCCTGGAGGCTATCCAGCGTACTCCAAAGATTCAGGTTTACTCACGTCATCCAGCAGAGAATGGA	Seq Length=72

AGATCCCACCAAAATCAAGTGGGGCGATGCTGGCGCTGAGTACGTCGTGGGGTCCACTGGCGTCTTCACCACCATGGAGAAGGCTGGGGCTCATTTGCAGGGGGGAGCCAAAAGGGTCATCATCTCTGCCCCCTCTGCTGACGCCCCCATG	Seq Length=151

TAGCTGTGCTCGCGCTACTCTCTCTTTCTGGCCTGGAGGCTATCCAGCGTACTCCAAAGATTCAGGTTTACTCACGTCATCCAGCAGAGAATGGA	Seq Length=95

AAAACAAGTGGGGCGATGCTGGCGCTGAGTACGTCGTGGAGTCCACTGGCGTCTTCACCACCATGGAGAAGGCTGGGGCTCATTTGCAGGGGGGAGCCAAAAGGGTCATCATCTCTGCCCCCTCTGCTGACGCCCCCATGTTCGTCATGGG	Seq Length=151

TGCAGAACCAGAATTTAAGGTGGAAGATGACATTTAATGGATCCTGCAGTAGTGTTTGCACATGGAAGTCCAAAAACCTGAAAGGAATATTTCAGTTCAGAGTAGTAGCTGCAAATAATCTAGGGTTTGGTGAATATAGTGGAATCAGTGA	Seq Length=151

TCCTGGCCTGGAGGCTATCCAGCGTACTCAAAAGATTCAGGTTTACTCACGTCATCCAGCAGAGAATGGA	Seq Length=70

TGGCCCGTAGGCTATCCAGCGTACTCCAAAGATTCAGGTTTACTCACGTCATCCAGCAGAGAATGGA	Seq Length=67

GGGCATTCCTGAAGCTGACAGCATTCGGGCCGAGATGTCTCGATCCGTGGCCTTAGCTGTGCTCGCGCTACTCTCTCTTTCTGGCCTGGAGGCTATCCAGAGTACTCCAAAGATTCAGGGTTACTCACGTCATCCAGAAGAGAATGGA	Seq Length=148

AGCGTGGCCTTAGCTGTGCTCGCGCTACTCTCTCCTTCTGGCCTGGAGGCTATCCAGCGTACTCCAAAGATTCAGGTTTACTCACGTCATCCAGCAGAGAATGGA	Seq Length=105

GGGGCATTACTGAAGCTGACAGCATTCGGGCCGAGATGTCTCGCTCCGTGGCCTTAGCTGTGCTCGCGCTACTCTCTCTTTCTGGCCTGGAGGCTATCCAGCGTACTCCAAAGATTCAGGTTTACTCACGTCATCCAGCAGAGAATGGAAG	Seq Length=151

NCACCACCCTGGAGAAGGCTGGGGCTCATTTGCAGGGGGGAGCCAAAAGGGTCATCATCTCTGCCCCCTCTGTTGATGCCCCCATGTTCGTCATGGGCGTGAACCA	Seq Length=106

GATTCCTGGAGCTGACAGCATTCGGGCCGAGATGTCTCGCTCCGTGGCCTTAGCTGTGCTCGCGCTACTCTCTCTTTCTGGCCTGGAGGCTATCCAGCGTACTCCCAAGATTCAGGTTTACTCACGTCATCCAGCAGAGAATGGA	Seq Length=145

ACCCATGGCAAATTCCATGGCACCGTCAAGGCTGAGAACGGGAAGCTTGTCATCAATGGAAATCCCATCACCATCTTCCAGGAGCGAGATCCCTCCAAAATCAAGTGGGGCGATGCTGGCGCTGAGTACGTCNNNGAGTCCACTGGCGTCN	Seq Length=151

NTTTGTGGCCTGGAGGCTATCCAGCGTACTCCAAAGATTCAGGTTTACTCACGTCATCCAGCAGAGAATGGA	Seq Length=72

CTTCAAAATCAAGTGGGGCGATGCTGGCGCTGAGTACGTCGTGGAGTCCACTGGCGTCTTCACCACCATGGAGAAGGCTGGGTCTCATTTGCAGGGGGTAGCCAAAAGGGTCATCCGCTCTGCCACCTCTTCTGACGCCCCCAGGTTCTT	Seq Length=150

GGGGCATTCCTGAAGCTGACAGCATTCGGGCCGAGATGTCTCGCTCCGTTGCCTTAGCTNTGCTCGCGCTACTCTCTCTTTCTGGCCTGGAGGCTATCCAGCGTACTCCAAAGATTCAGGTTTACTCACGTCATCCAGCAGAGAAACGAAG	Seq Length=151

GGGGCATTCCTGAAGCTGACAGCATTCGGGCCGAGATGTCTCGCTCCGTGGCCTTAGCTGTGCTCGCGCTACTCTCTCTTTCTGGCCTGGAGGCTATCCAGCGTACTCCAAAGATTCAGGTTTACTCACGTCATCCAGCAGAGAATGGAAG	Seq Length=151

GGGGCATTCCTGAAGATGACAGCATTCGGNCCGAGATGTCTCGCTCCGTGGNCNTAGNTGTGCTCGCGCTACTCTCTCTTTCTGGCATGGAGGCTATCCAGCGTACTCCAAAGATTCAGGTTTAGTCACTTCATCCAGCAGCGACTGGAAG	Seq Length=151

NATTCCTAGAGCTGACAGCATTCGGGCCGAGATGTCTCGCTCCGTGGCCTTAGCTGTGCTCGCGCTACTCTCTCTTTCTGGCCTGGAGGCTATCCAGCGTACTCCAAAGATTCAGGTTTACTCACGTCATCCAGCAGAGAATGGA	Seq Length=145

GCTTACGGATGGCGTGGAGCGGGCGCTGGGGCTGCAGCGTGTCAGCACCCTGCAGGACCTGCTCTTCCACAGCGACTGCGTGACCCTGCACTGCGGCCTCAACGAGCACAACCACCACCTCATCAACGACTTCACCGTCAAGCAGATG	Seq Length=148

TCACTGCGGACTCAACGAGCACAACCACCNCCNCATCAANNACNNNANNGTNAAGCANANGAGACAAGGGGCCTTCCTGGTGAACACAGCCCG	Seq Length=93

CGAATTCTGGCCTGGAGGCTATCCAGCGTACTCCAAAGATTCAGGTTTACTCACGTCATCCAGCAGAGAATGGA	Seq Length=74

CTTCTGGGCTGGAGGCTATCCAGCGTACTCCAAAGATTCAGGTTTACTCACGTCATCCAGCAGAGAATGGA	Seq Length=71

GGGGCCTTCCTGAAGCTGACAGCATTCGGGCCGAGATGTCTCGCTCCGTGGCCTTAGCTGTGCTCGCGCTACTCTCTCTTTCTGGCATGGAGGCTATCCAGCGTACTCCAAAGATTCAGGTTTAGTCACTTCATCCAGCAGCGACTGGAAG	Seq Length=151

TGATTCCTGAAGCTGACAGCATCCGGGCCGAGATGTCTCGCTCCGTGGCCTTAGCTGTGCTCGCGCTACTCTCTCTTTCTGGCCTGTAGGCTATCCAGCGTACTCCAAAGATTCAGGTTTACTCACGTCATCCAGCAGAGAATGGAAGAA	Seq Length=150

GGGCATTTCTGAAGCTGACAGCATTCGGGCCGAGATGTCTCGCTCCGTGGCCTTAGCTGNGCTCGCGCTACTCTCTCTTTCTGGCCTGGAGGCTATCCAGCGTACTCCAAAGATTCAGGTTTACTCACGTCATCCAGCAGAGAATGGA	Seq Length=148

GGGCATTTCTGAAGCTGACAGCATTCGGGCCGAGATGTCTCGCTCAGTGGCCTTAGCTGNGCTCGCGCTACTCTCTCTTTCTGGCCTGGAGGCTATCCAGCGTACTCCAAAGATTCAGGTTTACTCACGTCATCCAGCAGAGAATGGA	Seq Length=148

CTTTCTGGCCTGGAGGCTATCCAGCGTACTCAAAAGAATCAGGTTTACTCACGTCATCCAGCAGAGAATGGA	Seq Length=72

NAAATCAAGTGGGGCGATGCTGGCGCNNNGTACGTCGTGGAGTCCACTGGCGTCTTCACCACCATGGAGAAGGCTGGGGCTCATTTGCAGGGGGGAGCCAAAAGGGTCATCATCTCTGCCCCCTCTGCTGATGCCCCCATGTTCGTCATGG	Seq Length=151

ACTTTCTGGCCTGGAGGCTATCCAGCGTACTCCAAAGATTCAGGTTTACTCACGTCATCCAGCAGAGAATGGA	Seq Length=73

NTCTTTCTGGCCTGGAGGCTATCCAGNNNACTCCAAAGATTCAGGTTTACTCACGTCATCCAGCAGAGAATGGA	Seq Length=74

GGCCTAGAGGCTATCCAGCGTACTCCAAAGATTCAGGTTTACTCACGTCATCCAGCAGANAATGGA	Seq Length=66

CTGCCCCCTCTGCTGATGCCCCCATGTTCGTCATGGGTGTGAACCA	Seq Length=46

ATCAAGTGGGGCGATGCTGGCGCTGAGTACGTCGTGGAGTCCACTGGCGTCTTCACCACCATGGAGAAGGCTGGGGCTCATTTGCAGGGGGGAGCCAAAAGGGTCATCATCTCTGCCCCCTCTGCTGATGCCCCCATGTTCGTCATGGGTG	Seq Length=151

TCTCCAGCCGAGCCACATCGCTGAGACACCATGGGGAAGGTGAAGGTCGGAGTCAACGGATTTGGTCGTATTGGGCGCCTGGTCACCAGGGCTGCTTTTAACTCTGGTAAAGTGGATATTGTTGCCATCAATGACCCCTTCATTGACCTCA	Seq Length=151

AACTGGCCTGGAGGCTATCCAGCGTACTCCAAAGATTCAGGTTTACTCACGTCATCCAGCAGAGAATGGA	Seq Length=70

ATTCTGGCCTGNAGGCTATCCAGCGTACTCCAAAGATTCAGGTTTACTCACGTCATCCAGCAGAGAATGGA	Seq Length=71

GGATTGCCGGCCGAGCCACATCGCTGAGACACCATGGGGAAGGTGAAGGTCGGAGTCAACGGATTTGGTCGTATTGGGCGCCTGGTCACCAGGGCTGCTTTTAACTCTGGTAAAGTGGATATTGTTGCCATCAATGACCCCTTCATTGAC	Seq Length=150

GGGTTGCCGGCCGAGCCACATCGCTGAGACACCATGGGGAAGGTGAAGGTCGGAGTCAACGGATTTGGTCGTATTGGGCGCCTGGTCACCAGGGCTGCTTTTAACTCTGGTAAAGTGGATATTGTTGCCATCAATGACCCCTTCATTGAC	Seq Length=150

ACTCTGGCCTGGAGGCTATCCAGCGTACTCCAAAGATTCAGGTTTACTCACGTCATCCAGCAGAGAATGGA	Seq Length=71

GATTCAAGTTTACTCACGTCATCCAGCAGAGAATGGA	Seq Length=37

GGTCCCGGGGGATTAAAGCTGGCTATGGCACCTGCAACTGCTTCCCTGAGGAGGAGAAGTGCTTCTGCGAGCCCGAAGACATCCAGGATCCACTGTGCGACGAGCTGTGCCGCGCGGTGAT	Seq Length=121

CAGCAGGCCCGAGCCGCCTGGATACCGCAGCTAGGAATAATGGAATAGGACCGCGGTTCNATTTTGTTGGTTTTCGGAACTGAGGCNATGATTAAGAGAGACGGNTGGAGTG	Seq Length=112

CAGCAGGCCCGAGCCGCCTGGATACCGCAGCTAGGAATAATGGAATAGGACCGCGGTTCNATTTTGTTGGTTTTCGGAACTGAGGCNATGATTAAGAGAGACGGNTGGAGTG	Seq Length=112

NACCTTGAGGCTATCCAGCGTACTCCAAAGATTCAGGTTTACTCACGTCATCCAGCAGAGAATGGA	Seq Length=66

NTAGCTGTCGGATGGCGTGGAGCGGGCNNTGGGGCTGCAGCGTGTCAGCACCCTGCAGGACCTGCTCTTCCACAGCGACTGCGTGACCCTGCACTGCGGCCTCAACGAGCACAACCACCACCTCATCAACGACTTCACCGTCAAGCAGATG	Seq Length=151

NGTCCTAGCTGTGCTCGCGCTACTCTCTCTTTCTGGCCTGGAGGCTATCCAGCGTACTCCAAAGATTCAGGTTTACTCACGTCATCCAGCAGAGAATGGA	Seq Length=100

NGTCCTAGCTGTGCTCGCGCTACTCTCTCTTTCTGGCCTGGAGGCTATCCAGCGTACTCCAAAGATTCAGGTTTACTCACGTCATCCAGCAGAGAATGGA	Seq Length=100

TTCTGGGCCTGGAGGCTATCCAGCGTACTCCAAAGATTCAGGTTTACTCACGTCATCCAGCAGAGAATGGA	Seq Length=71

CACCCTGCACTTGTTGGCTTCTGACAAATGGAAAGTCCTGACACCCTTGTGATTTACTGGGATATCCTGTGGCACCTCTCCAAGTTGGTGGTCTGCCCAGACACTCATTGCTGTGNNGATGCCANNACTCTANNNTTTTCNNGNGTGGNAN	Seq Length=151

CATTTTCAGGGGGGAGCCAAAAGGGTCATCATCTCTGCCCCCTCTGCTGACGCCCCCATGTTCGTCATGGGTGTGAACCA	Seq Length=80

NGGGCATTCCTGAGGCTGACAGCATTCGGGCCGAGATGTCTCGCTCCGTGGCCTTAGCTGTGCTCGCGCTACTCTCTCTTATTGGCCTGGAGGATATCCATCGTACTCAAAAGATTCAGTTTTACTCAAGACATCCAGCAGATAATGGAAG	Seq Length=151

CGCTACTTGTCGGATGGCGTGGAGCGGGCGCTGGGGCTGCAGCGTGTCAGCACCCTGCAGGACCTGCTCTTCCACAGCGACTGCGTGACCCTGCACTGCGGCCTCAACGAGCACAACCGCCACCTCATCAACGACTTCACCGTCAAGC	Seq Length=148

GCGTGACCCTGCACTGCGGCCTCAACGAGCACAACCACCACCTCATCAACGACTTCACCGTCAAGCAGATGAGACAAGGGGCCTTCCTGGTGAACACAGCCCG	Seq Length=103

CCGATCATGAACGGGCCCCTGCACCCGCGGCCCCTGGTGGCATTGCTGGATGGCCGGGACTGCACAGTGGAGATGCCCATCCTGAAGGACGTGGCCACTGTGGCCTTCTGCGACGCGCAGTCCACGCAGGAGATCCATGAGAAGGTCCTGA	Seq Length=151

TGGCCATGGAGGCTATCCAGCGTACTCCAAAGATTCAGGTTTACTCACGTCATCCAGCAGAGAATGGA	Seq Length=68

CTCTGGCCCGGAGGCTATCCAGCGTACTCCAAAGATTAAGGTTTACTCACGTCATCCAGAAGAGAATGGA	Seq Length=70

TGAATGGCCTGGAGGCTATCCAGCGTACTCCAAAGATTCAGGTTTACTCACGTCATCCAGCAGAGAATGGA	Seq Length=71

TGTCTTAGCTGTGCTCGCGCTACTCTCTCTTTCTGGCCTGGAGGCTATCCAGCGTACTCCAAAGATTCAGGTTTACTCACGTCATCCAGCAGAGAATGGA	Seq Length=100

TTCTTGCCTGGAGGCTATCCAGCGTACTCCAAAGATTCAGGTTTACTCACGTCATCCAGCAGAGAATGGA	Seq Length=70

GATTCCTGGAGCTGACAGCATTCGGGCCGAGATGTCTCGCTCCGTGGCCTTAGCTGTGCTCGCGCTACTCTCTCTTTCTGGCCTGGAGGCTATCCAGCGTACTCCAAAGATTCAGGTTTACTCACGTCATCCAGCAGAGAATGGA	Seq Length=145

TTGGCCTGGAGGCTATCCAGCGTACTCCAAAGATTCAGGTTTACTCACGTCATCCAGCAGAGAATGGA	Seq Length=68

TGCACTGGGGCCTCAACGAGCACAACCACCACCTCATCAACGACTTCACCGTCAAGCAGATGAGACAAGGGGCCTTCCTGGTGAACACAGCCCG	Seq Length=94

GGTCTGGCCTAGAGGCTATCCAGCGTACTCCAAAGATTCAGGTTTACTCACGTCATCCAGCAGAGAATGGA	Seq Length=71

TTCTGGCCTGGAGGCTATCCAGCGTACTCCAAAGATTCAGGTTTACTCACGTCATCCAGCAGAGAATGGA	Seq Length=70

NATTTGCAGGGGGGTGCCAAAAGGGTCATCATCTCTGCCCCCTCTGCTGATGCCCCCATGTTCGTCATGGGTGTGAACCA	Seq Length=80

NTTTCGTGCCTGGAGGCTATCCAGCGTACTCCAAAGATTCAGGTTTACTCACGTCATCCAGCAGAGAATGGA	Seq Length=72

AGGACGCTTACTTGTCGGATGGCGTGGAGCGGGCGCTGGGGCTGCAGCGTGTCAGCACCCTGCAGGACCTGCTCTTCCACAGCGACCGCGTGACCCTGCACTGCGGCCTCAACGAGCACAACCACCACCTCATCAACGACTTCACCGTCAA	Seq Length=151

CTCGTTCTGGCCTGGAGGCTATCCAGCGTACTCCAAAGATTCAGGTTTACTCACGTCATCCAGCAGAGAATGGA	Seq Length=74

CGCTTTCTGGCCTGGAGGCTATCCAGCGTACTCCAAAGATTCAGGTTTACTCACGTCATCCAGCAGAGAATGGA	Seq Length=74

GGCATTCCCGAAGCTGACAGCATTCGGGCCGAGATGTCTCGCTCCGTGGCCTTAGCTGTGCTCGCGCTACTCTCTCTTTCTGGCCTGGAGGCTATCCAGCGTACTCCAAAGATTCAGGTTTACTAACGTCATCACGCCGCGTATCTCCT	Seq Length=149

GACAGCATTCGGGCCGAGATGTCTCGCTCCGTGGCCTTAGCTGTGCTCGCGCTACTCTCTCTTTCTGGCCTGGAGGCTATCCAGCGTACTCCAAAGATTCAGGTTTACTCACGTCATCCAGCAGAGAATGGA	Seq Length=132

AAAGCGAAGATTAGAGGTCTTGGGGCCGAAACGATCTCAACATATTCTAAAAGTTTAAATGGGTAAGAAGACCGGCTCGCTGGCGTGGAGCCGAGAGTGGAAAAAGAGTGCCTAGTGGGCCACTTTTGGTGGATGAGAAGGCGCTGAGGAA	Seq Length=151

TTTTCTGGCCTGGAGGCTATCCAGCGTACTCCAAAGATTCAGGTTTACTCACGTCATCCAGCAGAGAATGGA	Seq Length=72

AAAGGGAAAGGAGATAAAGAAAGGAAAAAGAAAATAAAAAGGAAGAGGAGGAGAAAACGAAAGAAGAAGAAAAGAAAGAGAATAAGAAGAAACAAAGGGAGGAAAAAGAGAAGAAAGAANAAAAAGAAGAAGGAGTGAGAAAAAGAACATA	Seq Length=151

ACAATGCTTAGACACCATGGGGAAGGTGAAGGTCGGAGTCAACGGANTTGGTCGTATTGGGCGCCTGGTCACCAGGGCTGCTTTTAACTCTGGTAAAGTGGATATTGTTGCCATCAATGACCCCTTCATTGACCTCAACTACATGGTTTAA	Seq Length=151

GACCCAGCACTGCGGCCTCAACGAGCACAACCACCACCTCATCAAGTAAAGCACCGTCAAGCAGATGAGAAAAGGGGCCTTCCTGGTGAACACAGACCGA	Seq Length=100

AATTTGCAGGGGGGAGCCAAAAGGGTCATCATCTCTGCCCCCTCTGCTGATTCCCCCATTTTCTTCATTGTTTTGAACCA	Seq Length=80

NCTGTGAAGCAGAATTCACCAAGCGTTGGATTGTTCACCCACTAATAGGGACCTTTAGCTGGGATTAGACCGTCGTGAGACAGGTTAGTTTTACCATACTGATGATGTGTTGTTGCCATGGTAATCCTGCTCAGTACGAGAGGAACCGCAG	Seq Length=151

AGCATACTCCAAAGATTCAGGTTTACTCACGTCATCCAGCAGAGAATGGA	Seq Length=50

GGGCTTTCCTGAAGCTGACAGCATTCGGGCCGAGATGTCTCGCTCCGTGGCCTTAGCTGTGCTCGCGCTACTCTCTCTTTCTGGCCTGGAGGCTATCCAGCGTACTCCAAAGATTCAGGTTTACTCACGTCATCCAGCAGAGAATGGA	Seq Length=148

CTCATTCCGGCCTGGAGGCTATACAGCGTACTCCAAAGATTCAGGTTTACTCACGTCATNCAGCAGAGAATGGA	Seq Length=74

>>>>>@BBBA>>EGEGGEAABF6DDF4A2BAADBAFGHH3BDDDB5BABGFADBBBBFB#ABBBBGHHHHFGHH	Seq Length=74

------------------
