ATACAGCGAAACCACAGCCAAGGGAACNNGGTTGGCGGAATCAGCGGGGAAAGAAGACCCTGTTGAGCTTGACTCTAGTCTGGCACGGTGAAGAGACGGCTGGAGTGTGAGGAAGGAAGAGCACACGTCTGAACTCCAGTTCACGTGTTTA	length=151

TAATAGACAGGAGGCTATACAGCGTACTCCAAAGATTCAGGTTTACTCACGTCATCCAGCAGAGAATGGA	Seq Percent=70%

TAATGGCCAGGAGGCTATACAGCGTACTCCAAAGATTCAGGTTTACTCACGTCATCCAGCAGAGAATGGA	Seq Percent=70%

AAAATCAAGTGGGGCGATGCTGGCGCTGAGTACGTCGTGGAGTCCACTGGAGTCTTCACCACCATGGAGAAGGCTGGGGCTCATTTGCAGGGGGGAGCCAAAAGGGTCATCAGCTCTGCCCCCTCTGCTGACGCACCCATGTTCGTCATGG	Seq Percent=151%

ATTCTGGCCTGGAGGCTATCCAGCGTACTCCAAAGATTCAGGTTTACTCACGTCATCCAGCAGAGAATGGA	Seq Percent=71%

NTATGGCCTGGAGGCTATCCAGCGTACTCCAAAGATTCAGGTTTACTCACGTCATCCAGCAGAGAATGGA	Seq Percent=70%

GGGGCCGAGATGTCTCGCTACGTGGCCTTAGCTGTGCTCGCGCTACTCTCTCTTTCTGGCCTGGAGGCTATCCAGCGTACTCCGAAGATTCAGGTTTACTCACGTCATCCAGCAGAGAATGGA	Seq Percent=123%

TCTGGCCCGGAGGCTATCCAGCGTACTCCAAAGATTCAGGTTTACTCACGTCATCCAGCAGAGAATGGA	Seq Percent=69%

GGGGCCTTCGCTGTGCTCGCGCTACTCTCTCTTTCTTGCCTGGAGGCTATCCAGCGTACTCCAAAGATTCAGGTTTACTCACTTCATCCAGCAGAGAATTGA	Seq Percent=102%

CTTTCTGGCCTGGAGGCTATCCAGCGTACTCCAAAGATTCAGGTTTACTCACGTCATCCAGCAGAGAATGGA	Seq Percent=72%

AAGGTTAACTCACGTCATCCAGCAGAGAATGGAAGATAGGAAGAGCAAACGTCTGAACTCCCTTCACGTGTTTATAAAGAAGTCCGGGGTGTGCATGACCAAAAAAAAGAAAAAATTTTANATCATTTACTTTATTCTTACTAACAATATA	Seq Percent=151%

AAGGTTAACTCACGTCATCCAGCAGAGAATGGA	Seq Percent=33%

AGGCATTCCTGAAGCTGACAGCATTCGGGCCGAGATGTCTCGCTCCGTGGCCTTAGCTGTGCTCGCGCTACTCTCTCTTTCTGGCCTGGAGGCTATCCAGCGTACTCCAAAGATTCAGGTTTACTCACGTCATCCAGCAGGGAATGGA	Seq Percent=148%

CTTTCAGGCCTGGAGGCTATCCAGCGNNNTCCAAAGATTCAGGTTTACTCACGTCATCCAGCAGAGAATGGA	Seq Percent=72%

GCCCCCTTGCTGACGCCCCCATGTTCGTCATGGGTGTGAACCA	Seq Percent=43%

TNCTTGCCTGGAGGCTATCCAGCGTACTCCAAAGATTCAGGTTTACTCACGTCATCCAGCAGAGAATGGA	Seq Percent=70%

GCGACCTGCGTGACCCTGCACTGCGGCCTCAACGAGCACAACCACCACCTCATCAACGACTTCACCGTCAAGCAGATGAGACAATGGGCCTTCCTGGTGAACACAGCCCG	Seq Percent=110%

TGGTACTAGTAGCAAATATTCAAACGAGAACTCTAGGAGAAGGCGAATTTGGAAGGGAGAGCGTCGAGATCC	Seq Percent=72%

NCCTTGCACTGCGGCCTCAACGAGCACAACCACCACCTCANNAACGACTTCACCGTCAAGCAGATGAGACAAGGGGCCTTCCTGGTGACACAGCCCG	Seq Percent=97%

CGATTCCTGAAGCTGACAGCATTCGGGCCGAGATGTCTCGCTCCGTGGCCTTAGCTGTGCTCGCGCTACTCTCTCTTTCTGGCCTGGAGGCTATCCAGCGTACTCCAAAGATTCAGGTTTACTCACGTCATCCAGCAGAGAATGGA	Seq Percent=146%

CTCTTTCTGGCCTGGAGGCTATCCAGCGTACTCCAAAGATTCAGGTTTACTCACGTCATCCAGCAGAGAATGGA	Seq Percent=74%

TTCTTGCCTGGAGGCTATCCAGCGTACTCCAAAGATTCAGGTTTACTCACGTCATCCAGCAGAGAATGGA	Seq Percent=70%

ACTGATTCAGGTTTACTCACGTCATCCAGCAGAGAATGGA	Seq Percent=40%

TTATGGCCTGGAGGCTATCCAGCGTACTCCAAAGATTCAGGTTTACTCACGTCATCCAGCAGAGAATGGA	Seq Percent=70%

ACTTCCTTGTCGGATGGCGTGGAGCGGGCGCTGGGGCTGCAGCGTGTCAGCACCCTGCAGGACCTGCTCTTCCACAGCGACTGCGTGACCCTGCACTGCGGCCTCAACGAGCACAACCACCACCTCATCAACGACTTCACCGTCANGC	Seq Percent=148%

TCTCGCTCCGTGGCCTTAGCTGTGCTCGCGCTACTCTCTCTTTCTGGCCTGGAGGCTATCCAGCGTACTCCAAAGATTCAGGTTTACTCACGTCATCCAGCAGAGAATGGA	Seq Percent=111%

GGTTTGGTAGTNGTTTTGACAACATCGACATCAAGTCGGCCGGGGATTTAGGCATTGCCGTCTGCAACGTGCCCGCGGCGTCTGTGGAGGAGACGGCCGACTCGACGCTGTGCCACATCCTGAACCTGTACCGGCGGGCCACCTGGATGCA	Seq Percent=151%

ACTGCTGTCGGATGGCGTGGAGCGGGCGCTGGGGCTGCAGCGTGTCAGCACCCTGCAGGACCTGCTCTTCCACAGCGACTGCGTGACCCTGCACTGCGGCCTCAACGAGCACAACCACCACCTCATCAACGACTTCGCCGTCAAGCAGATG	Seq Percent=151%

GTGCCCGCGCTACTCTCTCTTTCTGGCCTGGAGGCTATCCAGCGTACTCCAAAGATTCAGGTTTACTCACGTCATCCAGCAGAGAATGGA	Seq Percent=90%

AGGCAGTGGCGCTGCGGGCCAAGGCCTTAGGCTTCAACGTGCTCTTCTACGACCCTTACTTGTCGGATGGCGTGGAGCGGGCGCTGGGGCTGCAGCGTGTCAGCACCCTGCAGGACCTGCTCTTCCACAGCGACTGCGTGACCCTGCA	Seq Percent=148%

AGGCAGTGGCGCTGCGGGCCAAGGCCTTAGGCTTCAACGTGCTCTTCTACGACCCTTACTTGTCGGATGGCGTGGAGCGGGCGCTGGGGCTGCAGCGTGTCAGCACCCTGCAGGACCTGCTCTTCCACAGCGACTGCGTGACCCTGCA	Seq Percent=148%

AGGCAGTGGCGCTGCGGGCCAAGGCCTTAGGCTTCAACGTGCTCTTCTACGACCCTTACTTGTCGGATGGCGTGGAGCGGGCGCTGGGGCTGCAGCGTGTCAGCACCCTGCAGGACCTGCTCTTCCACAGCGACTGCGTGACCCTGCA	Seq Percent=148%

GGTGGGGCGATNCTGGCGCTGAGTACGTAGTGGAGTCCACTGGCGTCTTCACCACCATGGAGAAGGCTGGGGCTCATTTGCAGGGGGGAGCCAAAAGGGTCATCATCTCTGCCCCCTCTGCTGATGCCCCCATGTTCGTCATGGGTGTGAA	Seq Percent=151%

CAAGTGTGGCGATGATGGAGCTGATTACGTCGTGGAGTCCACTGGCGTCTTCACCACCATGGAGAAGGCTGGGGCTCATTTGCAGGGGGGAGCCAAAAGGGTCATCATCTCTGCCCCCTCTGCTGACGCCCCCATGTTCGTCATGGGTGTG	Seq Percent=151%

TTCTGGCCTGGNAGCTATCCAGCGTACTCCAAAGATTCAGGTTTACTCACGTCATCCAGCAGAGAATGGA	Seq Percent=70%

AGGTTGGCAAGGTGAATAGACGGCTGGAGTGTGAGGAAGGGAGAGCGACGAGCTACAACCCAAGAGGAGATTGAAAGATAGGAAGAGAACACGTATGAACTAGAGTAAAGAGTTTATCTCNTATGCCGGCTTCTGATGGAACAACAAAAAA	Seq Percent=151%

GTTCTGGCCTGGAGGCTATCCAGCGTAANCCAAAGATTCAGGTTTACTCACGTCATCCAGCAGAGAATGGA	Seq Percent=71%

GGTTTTGGTCGTATTGGGCGCCTGGTNNNCAGGGCTGCTTTTAACTCTGGTAAAGTGGATATTGTTGCCATCAATGACCCCTTCATTGACCTCAACTACATGGTTTACATGTTCCAATATGATTCCACCCATGGCAAATTCCATGGCACCG	Seq Percent=151%

GCTGCATTCGGGCCGAGATGTCTCGCTCCGTGGCCTTAGCTGTGCTCGCGCTACTCTCTCTTTCTGGCCTGGAGGCTATCCAGCGTACTCCAAAGATTCAGGTTTACTCACGTCATCCAGCAGAGAATGGA	Seq Percent=131%

CGAAGCTGACAGCATTCGGGCCGAGATGTCTCGCTCCGTGGCCTTAGCTGTGCTCGCGCTACTCTCTCTTTCTGGCCTGGAGGCTATCCAGCGTACTCCAAAGATTCAGGTTTACTCACGNCATCCAGCAGAGAATGGA	Seq Percent=139%

CTTCTGGCTTGGAGGCTATCCAGCGTACTCCAAAGATTCAGGTTTACTCACGTCATCCAGCAGAGAATGGA	Seq Percent=71%

NTCTGGCCTGGAGGCTATCCAGCGTACTCCAAAGATTCAGGTTTACTCACGTCATCCAGCAGAGAATGGA	Seq Percent=70%

GACTATCCCAATTTCCAAGGGAGGCTGNNGAATTTTAGAATACAATTTTCATGATTAGCTTTGATCAATTGCGTGGGACTGGGAACCTGGCCTCCAAGAAATAAATCGAAAGCAAGGAGATGGAGAAAACATATTGAAAAGAAAATTTTGA	Seq Percent=151%

ACCACGCCATCACTCTCACCAGGGAGGACCTGGAGAAGTTCAAAGCCCTCCGCATCATCGTCCGGATTGGCAGTGGTTTTGACAACATCGACATCAAGTCGGCCGGGGATTTAGGCATTGCCGTCTGCAACGTGCCCGCGGCGTCTGTTGA	Seq Percent=151%

TTGTGACCTGGAGGCTATCCAGCGTACTCCAAAGATTCAGGTTTACTCACGTCATCCAGCAGAGAATGGA	Seq Percent=70%

TTTCTTGCCTGGAGGCTATCCAGCGTACTCCAAAGATTCAGGTTTACTCACGTCATCCAGCAGAGAATGGA	Seq Percent=71%

NTCTGGCCTGGAGGCTATCCAGCGTACTACAAAGATTCAGGTTTACTNACGTCATCCAGCAGAGAATGGA	Seq Percent=70%

CCAAAGATTCAGGTTTACTCACGTNNNNNNNCAGAGAATGGA	Seq Percent=42%

CCACCATTACACTCTTTCCCTACACGNNNNTCTTCCCGAA	Seq Percent=40%

ATTCTGTCCTGGAGGCTATCCAGCGTACNCCAAAGATTCAGGTTTACTCACGTCATCCAGCAGAGAATGGA	Seq Percent=71%

GGAATAAATGAAGATGAAAGCATTCGGGCCGAGATGTCTCGCTCCGTGGCCTTAGATGTGCTCGCGCTACTCTCTCTTTCTGGCCTGGAGGCTATCCAGCGTACTCCAAAGATTCAGGTATACTCACGTCATCCAGCAGAGAATGGA	Seq Percent=147%

TTCGTGCCTGGAGGCTATCCAGCGTACTCCAGGGATTCAGGTTTACTCACGTCATCCAGCAGAGAATGGA	Seq Percent=70%

GGCTGACAGCATTCGGGCCGAGATGTCTCGCTCCGTGGCCTTAGCTGTGCTCGCGCTACTCTCTCTTTCTAGCCTGGAGGCTATCCAGCGTACTCCAAAGATTCAGGTTTACTCACGTCATCCAGCAGAGAATGGA	Seq Percent=136%

GACTTGGAGGCTATCCAGCGTACTCCAAATATTCAGGTTTACTCACGTCATCCAGCAGAGNATGGA	Seq Percent=66%

ATCACCATCTTCCAGGAGCGAGATCCCNNCAAAATCAAGTGGGGCGATGCTGGCGCTGAGTACGTCGTGGAGTCCACTGGCGTCTTCACCACCATGGAGAAGGCTGGGGCTCATTTGCAGGGGGGAGCCAAAAGGGTCATCATCTCTGCC	Seq Percent=150%

CATTTGCAGGGGGGAGCAAAAAGGGTCATAATCTCTGCCCCCTCTGCTGACGCCCACATGTTCGTCATGGGTGTGAACCA	Seq Percent=80%

GGGGCATTCCTGAAGCTGACAGCATTCGGGCCGAGATGTCTCGCTCCGTGGCCTTAGCTGTGCTCGCGCTACTCTCTCTTTCTGGCCCGGAGGCTATCCAGCGTACTCCAAAGATTCAGGTTTACTCACGTCATCCAGCAGAGAATGGAAG	Seq Percent=151%

CATAACAAGGAGAACAAATTCCGGGACCGCTCGTTTAGCGAGAACGGCGATCGCAGCCAGCACCTCCTGCACCTGCAGCAGCAGCAGAAGGGGGGCGGCGGCTCCCAGATCAACTCCACGCGCTACAAGACCGAGCTGTGCCGGCCCTTCG	Seq Percent=151%

TGTTCGGGCTGTCAGGAGGCGACACGAGGCCCAGCGCTGCCCCCTCCCGCCTCCTGACAGCCCGGACCAGTCTCTGCAGTGGCGCTGCGGGCCAAGGCCTTCGGCTTCAACGTGCTCTTCTACGACCCTTACTTGTCGGATGGCGTGGAG	Seq Percent=150%

CCGGGGCTGCTTTTAACTCTGGTAAANNNNNTATTGTTGCCATCAATGACCCCTTCATTGACCTCAACTACATGGTTTACATGTTCCAATATGATTCCACCCATGGCAAATTCCATGGCACCGTCAAGGCTGAGAACGGGAAGCTTGTCAT	Seq Percent=151%

GACCTCGGGAAAAACTGACTCTGCGTNNNNTGCTGGGAAGTGGAGCCTTTGGAGAAGTGTATGAAGGAACAGCAGTGGACATCTTAGGAGTTGGAAGTGGAGAAATCAAAGTAGCAGTGAAGACTTTGAAGAAGGGTTCCACAGACCAGGA	Seq Percent=151%

AATGCACTGCGGCCTCAACGAGCACAACNCCACCTCATCAACGACTTCACCGTCAAGCAGATGAGACAAGGGGCCTTCCTGGTGAACACAGCCCG	Seq Percent=95%

GGGGCATTCCTGAAGCTGACAGCATTCGTGCCGAGATGTCTCGCTCCGTGGCCTTAGCTGTGCTCGCGCTACTCTCTCTTTCTGGCCTGGAGGCTATCCAGCGTACTCCAAAGATTCAGGTTTACTCACGTCATCCAGCAGAGAATGGAAG	Seq Percent=151%

GGCACGTCAAGGCTGAGAACGGGAAGCTTGTCATCAATGGAAATCCCATCACCATCTTCCAGGAGCGAGATCCCTCCAAAATCAAGTGGGGCGATGCTGGCGCTGAGTACGTCGTGGAGTCCACTGGCGTCTTCACCACCATGGAGAAGG	Seq Percent=150%

TTTCTGCCCTGGAGGCTATCNAGCGTNNNNCAAAGAGTCAGGTTTACTCACGTCATCCAGCAGAGAATGGAAGATCGGAAGAGAAAACGTCTGAACTCGAGTAACGTGTTTATCTGGTATGGAGGAGGCGGGTTGAAAACCAAACAAGGAG	Seq Percent=151%

TTTCTGGCCTGGAGGCTATCNAGCGTANNCCAAAGATTCAGGTTTACTCACGTCATCCAGCAGAGAATGGA	Seq Percent=71%

GTTACTAGTCGGATGGCGTGGAGCGGGCGCTGGGGCTGCAGCGTGTCAGCACCCTGCAGGACCTGCTCTTCCACAGCGACTGCGTGACCCTGCACTGCGGCCTCAACGAGCACAACCACCACCTCATCAGCGACTTCACCGTCAAGC	Seq Percent=147%

GCCCCATAAGATCGGAAAGCCCCCTTCTTCCCTCCAGTCACGTGTTTATCTCGTATGCCGTCTTCTGCTTGAAAAAAAAAAAAAAAACAAAAAAAACAAAAAAAAACAAGATACAAGAAAAAAAATAAAAAAAAAAAAAGAAAAAAAACAA	Seq Percent=151%

TGGGGCATTCCTGAAGCTGCCCGCCTTCTTTCCGAGATGTCTCGCTCCGTGGCCTTAGCTGTGCTCGCGCTACTCTCTCTTTCTGGCCTGGAGGCTATCCAGCGTACTCCAAAGATTCAGGTTTACTCACGTCATCCAGCAGAGAATGGAA	Seq Percent=151%

AGATTCCTGAAGCTGACAGCATTCGGGCCTAGATGTCTAGCTACGTGGCCTTATCTGTGCTCGCGCTACTCTCTCTTTATGGCCTGGAGGCTATCCAGCGTAATCAAAAGATAAGGGTTTACTCACGTAATCCAGCAAAGAAAGGA	Seq Percent=146%

TGGGGCATACCTGAAGCTGACAGCATTCTGGCCGAGATGTCTCGCTCCGTGGCCTTAGCTGTGCTCGCGCTACTCTCTCTTTCTGGCCTGGAGGCTATCCAGCGTACTCCAAAGATTCAGGTTTACTCACGTCATCCAGCAGAGAATGGAA	Seq Percent=151%

GTTCCTGAAGCTGACAGCATTCGGGCCGAGATGTCTCGCTCCGTGGCCTTAGCTGTGCTCGCACTACTCTCTCTTTCTGGCCTGGAGGCTATCCAGCGTACTCCAAAGATTCAGGTTTACTCACGTCATCCAGCAGAGAATGGA	Seq Percent=144%

CCAGCGTACTCCAAAGATTCAGGTTTACTCACGTCATCCAGCAGAGAATGGA	Seq Percent=52%

CAAGCAGATGAGACAAGGGGCCTTCCTGGTGAACACAGCCCG	Seq Percent=42%

CTCCAAAATCAAGTGGGGCGATGCTGGCGCTGAGTACGTCGTGGAGTCCACTGGCGTCTTCACCACCATGGAGAAAGCTGGGGCTCATTTGCAGGGGGGAGCCAAAAGGGTCATCATCTCTGCCCCCTCTGCTGATGCCCCCATGTTCGT	Seq Percent=150%

TTTCCTTATCTTTGCTCGCGCTACTCNNNCTTTCTGGCCTGGAGGCTCTCCAGCGTACTCCAAAGATTCAGGTTTACTCACGTCATCCAGCAGAGAATGTA	Seq Percent=101%

TTCTGGCCTGGAGGCTATCCAGCGTACTCCAAAGATTCAGGTTTACTCACGTCATCCAGCAGAGAATGGA	Seq Percent=70%

GGGGCATTCCTGAAGCTGACAGCATTNNNGCCGAGATGTCTCGCTCCGTGGCCTTAGCTGTGCTCGCGCTACTCTCTCTTTCTGGCCCGGAGGCTATCCAGCGTACTCCAAAGATTCAGGTTTACTCACGTCATCCAGCAGAGAATGTAAG	Seq Percent=151%

GATAACACCCATGGCAAATTCCATGGCACCGTCAAGGCTGAGAACGGGAAGCTTGTCATCAATGGAAATCCCATCACCATCTTCCAGGAGCGAGATCCCTCCAAAATCAAGTGGGGCGATGCTGGCGCTGAGTACGTCGTGGAGTCCACTT	Seq Percent=151%

TNTGGCCTGGAGGCTATCCAGCGTACTCCAAAGATTCAGGTTTACTCACGTCATCCAGCAGAGAATGGA	Seq Percent=69%

GATTCCTGAAGCTGACAGCATTCGGGCAGAGATGTATCGCTCAGTGGCCTTAGCTGTGCTAGCGCTACTCTCTCTGTATGGCCTGCAGGCTATCAAGAGTGCTCAAAAGATTCAGGTTTACTCACGTCATCCAGCAGATACTGGA	Seq Percent=145%

NCTGGCCTGGAGGCTATCCAGCGTACTCCAAAGATTCAGGTTTACTCACGTCATCCAGCAGAGAATGGA	Seq Percent=69%

CATTGTGGCCTGGAGGCTATCCAGCGTACTCCAAAGATTCAGGTTTACTCACGTCATCCAGCAGAGAATGGA	Seq Percent=72%

TGTTTAATCACGTCATCCAGCAGAGAATGGA	Seq Percent=31%

ACCTTAGCTGTGCTCGCGCTACTCTCNNNNNCTGGCCTGGAGGCTATCCAGCGTACTCCAAAGATTCAGGTTTACTCACGTCATCCAGCAGAGAATGGA	Seq Percent=99%

ATTCCTGAAGCTGACAGCATTCGGGCCGAGATGTCTCGCTCCGTGGCCTTAGCTGTGCTCGCGCTACTCTCTCTTTCTGGCCTGGAGGCTATCCAGCGTACTCCAAAGATTCAGGTTTACTCACGTCATCCAGCAGAGAATGGA	Seq Percent=144%

CAGGGGCATTCCTGAAGCTGACAGCATTCGGGCCGAGATGTCTCGCTCCGTGGCCTTAGCTGTGCTCGCGCTACTCTCTCTTTCTGGCCTGGAGGCTATCCAGCGTACTCCAAAGATTCAGGTTTACTCACGTNATCCAGCAGAGAATGGA	Seq Percent=151%

TCACCACCCCATCAACGACTTCACCGTCAAGCAGATGAGACAAGGGGCCTTCCTGGTGAACACAGCCCG	Seq Percent=69%

AAGATAGCCAAATGCCTCGTCATCTAATTAGTGACGCGCATGAATGGATGAACGAGATTCCCACTGTCCCTACCTACTATCCAGCGAAACCACAGCCAAGGGAACGGGCTTGGCGGAATCAGCGGGGAAAGAAGACCCTGTTGAGCTTGA	Seq Percent=150%

ATTACCTCGGATGGCGTGGAGCGGGCGCTGGGGCTGCAGCGTGTCAGCACCCTGCAGGACCTGCTCTTCCACAGCGACTGCGTGAACCTGCACTGCGGCATCAACGAGCACAACCACCAAATAATCAACTACTCAAGAGTAAAGCAGATGA	Seq Percent=151%

CACCTGGCCTGGAGGCTATCCAGCGTACTCCAAAGATTCAGGTTTACTCACGTCATCCAGCAGAGAATGGA	Seq Percent=71%

AAGAAAAATAATTGTCGGATGGCGTGGAGAGGGCGCTGGGGATGCAGAGTGTCAGAACCCTGCAGGACCTGCTCTTCCACAGCGACTGCGTGACCCTGCACTGCGGCCTCAACGAGCACAACCACCACCTCATCAACGACTTCACCGTCAA	Seq Percent=151%

GAGTCCACAGGCGTCTTCACNACCATANNNAAGGCTGGGGCTCATTTGCAGGGGGGAGCCAAAAGGGTCATCATCTCTGCCCCCTCTGCTGATGCCCCCATGTTCGTCATGGGTGTGAACCA	Seq Percent=122%

CTTCTGGCCTGGAGGCTATCCAGCGTACTCCAAAGATTCAGGTTTACTCACGTCATCCAGCAGAGAATGGA	Seq Percent=71%

GTGGCCTCAGCTGTGCTCGCGCTACTCNNTCTTTCTGGCCTGGAGGCTATCCAGCGTACTCCAAAGATTCAGGTTTACTCACGTCATCCAGCAGAGAATGGA	Seq Percent=102%

ACTTTCAGGCCAGGAGGCTATCCAGCGTACTCCAAAGATGGAGGATTAATCACGTCATCAAGAAGAGAATGGAAGATAAGAAGAGCAGAAGAATGAAATCCAAGAACTTGTTTAACTCGTATGCCGTCTTCTGCTTGAAAAAAAAAAAAAA	Seq Percent=151%

GTGTCTCGCTCCGTGGCCTTAGCTGTGCTCGCGCTACTCTCTATTTCTGGCCTGGAGGATATACAGCGTAATCCAAAGATTCAGGTTTACTCACGTCATCCATAATATAATGGT	Seq Percent=114%

ATGAACATGAGATCGGAAGAGCACACGTCTGAAATACAGTAAAGAGTATAACTCGTATGCCGTCTACTGCTTGAAAAAAAAAAATCAAAAAAATTAAATTAAAAAAAAAGAGAAACCTAATATCACATATCACACAAACACCAACAAAACA	Seq Percent=151%

GGTTTACTCACGTCATCCAGCAGAGAATGGA	Seq Percent=31%

ATCCAGAGGACACCAAAGATTCAGGTTTACTCAAGTCATCAAGAAGAGAATGGAAGATAGGAAGAGCACACGTCAGAACTCAAGTCAAGTGTTTATAACGTATGACGAAGTAGGATTGAAAAACACACACCAAACAAACACCAACAAATAA	Seq Percent=151%

ATCTGCAACCTATGCTGACGCCCCCATGTTCGTAATGAGTGTGAAACAAGATCGGAAGAGCACACGCATGAACTCAAGTAAAGTGTATATCTCGTAAGCCGAATAATGAGTGAAACAAAAAAACACACACATTTCAAACCCTAACAAAAAA	Seq Percent=151%

TGTGGCAAGGAGGCTATCCAGCGTACTCCAAAGATTCAGGATTAATAAAGTCATCCAGCAGAGAATGGAAGATAGGAAAAGAACACGTAAGAACAACAGTAAAGAGTTTATATAGTATGCCGTCTTCTGCTTGNAAAAAAAAAAAAAAAAA	Seq Percent=151%

ANTCTGGGCTGGAGGCTATCCAGCGTACTCCAAAGATACAGGATTACAAAAGTCATACAGCAGAGAATGGAAGACAGGAAGAGCACAAGTCTGAACAACAGTAAAGTGAGTAGAACGTATGCCGACTTCTGCTTGAAACAACAACAAAAAA	Seq Percent=151%

TTCTGGCGTGGGGGCTATCCAGCGTACTCCAACGATTCAGGTTTAATAACGTCCTCCCGCAGAGACTGGTCGAACGGAAGAGCACACGTATGACGTCCAGTCACGTGTTTAAATAGTATGACGTATTCGGCTTGAAAAAAAAAAAAAA	Seq Percent=148%

CACCTGGCCTGGAGGCTATCCAGCGTNNNCCAAATATTCAGGTTTACTCACGTCATCCATCAGAGAATGGAAGATCTTAATAGCACACGTCTGAACTCCATTCACTTTTTTATCTCGTATGCCGTCTTCTGCTTGAAAAAAAAAAAAAAAA	Seq Percent=151%

GAGTACAGCGTGGAGTCCACTGGCGTCTTCACCACCATGGAGAAGACTGGGGCTCATTTGCAGGGGGGAGCCAAAAGGGTCATCATCTCTGCCCCCTCTGCTGATGCCCCCATGTTCGTCATGGGTGTGAACCA	Seq Percent=134%

CTCTTTCTGGCCTGGAGGCTATCCAGCGTACTCCAAAGATTCAGGTTTACTCACGTAATCCAGCAGAGAATGGA	Seq Percent=74%

TCATTCCTGAAGCTGACAGCATTCGGGCCGAGATTTCTCGCTCCTTGGCCTTAGCTGTTCTCGCGCTACTCTCTCTTTCTTGCCTGGATGCTATCCAGCGTACTCCAACGATTCATGTTTACTCACGTCATCCAGCAGAGAATGGA	Seq Percent=146%

CTGCCCCCTCTGCTGATGCCCCCATGTTCGTCATGGGTGTGAACCA	Seq Percent=46%

GATAGAGGAATTATGAGGGAAAGATACCAAGTCACGGTTTATTCTTCAAAATGGAGGTGGCTTGTTGGGAAGGTGGAAGCTCATTTGGCCAGAGTGGAAATTGAATTGGGAGAAATCGATGACCAAATGTAAACACTTTGTTCTTTATATA	Seq Percent=151%

TGATGGAATGGAGGATATAAAGAGTAATAAAAAGATTCAGGTTTACTAACGTCATACAGAAGAGAAGGGAAGATAGGAAGAGCACAAATATGAAATAAAGTCAAGTGTTTATCTGGTATGCCGTCTTCTGCTTGAAAAAAAAAAAAAAAAA	Seq Percent=151%

CCAAATTCAATTTTGGCGATGCTGGCGCTGAGTACGTCGTAGAGTCCACTGGCGTCTTCACCACCATTGAGAAGGCTGGGGCTCATTTGCAGTTGGGAGCCAAAAGGGTCATCATCTCTGCCCCCTCTGCTGATGCCCCCATGTTCGTCAT	Seq Percent=151%

GACCTGTTCATTCAGCAATAGACGGCTTTAGTTTGAGGAGTGTGGCGGCCTGGGCTCCCCAACAGTCAGGTGTGAGTGGAGGCAAGGAGATGTCAAAGGGATCACCAGGAACTTCTCCACCCGCTCTCCCAGCACCA	Seq Percent=137%

CGCGTTTTCTTCTGGCGTTGCGCGGTCGCTGGGGCTTCAGCGTTTCCTCCCCCTGCAGGCCCTGCTCTTCCACAGCTACTTCTTTACCCTGCACTTCTGCCTCAACTCTCCCCACCACCACCTCATCCACGCCTTCACCGTCAATCAGATT	Seq Percent=151%

TTCTTGCCTTTATTCTATCCAGCGTACTACAAAGATTCAGGTTTACTCACGTCATCCAGCAGATAATTGA	Seq Percent=70%

CTGGTAATAATATATGAAACCTCTGCTGACGCACCCATTTTCTTCATGGTTGTGAAAAAATATAGGAAGAGAAAACTTCTGAACTCCATGCACGTTTTTATCTCTTATGCCGTCTTCTGCTTGAAAAAAAAAAAAAAAAATAACTAAAATA	Seq Percent=151%

GTTGCATTCCTTAAGCTGACAGCATTCTNTCCGATATGTCTCTCTCCGTGGCCTTAGCTGTGCTCGCGCTACCCTCTCTTTCTGGCCTGTATTCTATCCAGCGGACTCCAAAGATTCGGGTTTACTCACGTCATCCAGCAGAGAATGGAAG	Seq Percent=151%

GTTTACGATGTTAGTCGCCGTGCCTACCNTGGTGACCACGGGAGACGGCTTGAGTGTGATGAAGGGGGAGCGGCG	Seq Percent=75%

CAATTTTCTTTTCTCGCGCTACTCTCTCTTTCTGGCCTGGAGGCTATCCAGCGTCCTCCAAAGATTAAGTTGTACTCACGTCATCCAGCATATAATGGA	Seq Percent=99%

CTGACCACTATGCTGACGCAACCATGNNNNNCATGGGTGTGCACCAAGATAGGAAGAGAACACGTATGAACTCCATTCAAGAGTTTATATCGTATGCAGTATTCTGATTGAAAAAAAAAAAATAAAACACATAACACACATCAACTTT	Seq Percent=148%

GGGGAAATAATAAAGCTGACAGCATTCGGGCCGAGATGTCTCGCTACGTGGCCTTAGATGTGCTCGAGCTACTCTCTCTTTATGGCATGGAGGATATACAGAGTAATAAAAAGATTCAGGTTTACTCAAGTCATCAAACAGAGAATGGAAG	Seq Percent=151%

TTCCTTGCCTTGATGCTATCCATCGTNNNCCAAAGATTCCGGTTTACTCACTTCATCCAGCAGAGAATGGA	Seq Percent=71%

GTTCCTTCCTTAATCTTACATCATTCGTGCCTAGATGTCTCGCTCCGTGGCCTTAGCTGTGCTCGCGCTACTCTCTCTTTCTGGCCTGGATTCTATCCAGCGTACTCCAAAGATTCAGGTTTACTCACGTCATCCAGCAGAGAATGGA	Seq Percent=148%

GCTTTTCAATTCCTTCTTCTTCAACTTTCTCTTCTACGACCCTTCCTTGTCTTATGGCGTGTAGCGGGCGCTGGGGCTGCAGCGTGTCATCACCCTGCAGGACCTGCTCTTCCACAGCGANTGCGTGACCCTGCACTGCGGCCTCAACGAG	Seq Percent=151%

GCGTGACCCTGCACTGCGGCCTCAACGAGCACAACCACCACCTCATCAACGACTTCACCGTCAAGCAGATGAGACAAGGGGCCTTCCTGGTGAAAACAGCCCG	Seq Percent=103%

CCTGCCCCCTCTGCTGATGCNCCCATGTTCGTCATGGGTGTGAACCA	Seq Percent=47%

CAGAAGGATGGCGTGGAGCGNGCGCTGGGGCTGCAGCGTGTCAGCACCCTGCAGGACCTGCTCTTCCACAGCGACTGCGTGACCCTGCACTGCGGCCTCAACGAGCACAACCACCACCTCATCAACGACTTCACCGTCAAGCAGATG	Seq Percent=147%

GGAAATCCCATCACCATCTTNCAGGANNNNGATCCCTCCAAAATCAAGTGGGGCGATGCTGGCGCTGAGTACGTCGTGGAGTCCACTGGCGTCTTCACCACCATGGAGAAGGCTGGGGCTCATTTGCAGGGGGGAGCCAAAAGGGTCATCA	Seq Percent=151%

TTCATGGCCTGGAGGCTATAAAGAGTNNNAAAAAGATTCAGGTTTACTCACGTCATCCAGCAGAGAATGGA	Seq Percent=71%

ATGCCCGTCTGATGACTCCCCCATGTCCGTCCTGGGTGTGAAACAAGATCGTCCTCGCACACGTCTGAACTCCAGTCAAGTGGTTATCTCGTATGCCGGATGATTCTGGAAAAAAAAAAGGAAAAAAAAAAAAGGAAAGAAAAAGGGGAGG	Seq Percent=151%

TCTGCCTGGAGGCTATCCAGNGTACTCCAAAGATTCAGGTTTACTCACGTCATCCAGCAGAGAATGGA	Seq Percent=68%

CCATGCACTGCGGCCTCAACGAGCACANNCACCACCTCATCAACGACTTCACCGTCGAGCAGATGAGACAAGGGGCCTTCCTGGTGAACACAGCCCG	Seq Percent=97%

TTAGGCTGAGAACGGGAAGCTTGTCATCAATGGAAATCCCATCACCATCTTCCAGGAGCGAGATCCCTCCAAAATCAAGTGGGGCGATGCTGGCGCTGAGTACGTCGTGGAGTCCACTGGCGTCTTCACCACCATGGAGAAGGCTGGGG	Seq Percent=149%

GTGTACTCCAAAGATTCAGGNTTACTNNNNNCATCCAGCAGAGAATGGA	Seq Percent=49%

GGCCTGGATGCTATCCAGCGTACTCCAAAGATTCAGGTTTACTCACGTCATCCAGCAGAGAATGGA	Seq Percent=66%

GCATTCCAGAAGCTGACAGCATTCGGGCCGAGATGTCTCGCTCCGTGGCCTTAGCTGTGCTCGCGCTACTCTCTCTTTCTGGCCTGGAGGCTATCCAGCGTACTCCAAAGATTCAGGTTTACTCACGTCATCCAGCAGAGAATGGA	Seq Percent=146%

GCGTACTCCAAAGATTCAGGTTTACTNNNNNCATCCAGCAGAGAATGGA	Seq Percent=49%

CCTCCAAAGTCAAGTGGGGCTATGCTGGCGCTGAGTACGTCGTGGAGTCCACTGGCGTCTTCACCACCATGGAGAAGGCTGGGGCTCATTTGCAGGGGGGAGCCAAAAGGGTCATCATCTNTGCCCCCTCTGCTGACGCCCCCATGTTCGT	Seq Percent=151%

ACATAAAAAGAATTTCCGGTGGAAGATGAGATCGGAAGAGCAAACGTATGACCTCCATTCACGTGTTTATCTCGTATGACGACTTCGGCTTGAAAAAAACAAAAAAAAAAAAAAATTACGTTTACTGCATTAAGAGGGATACGAAAAAAAT	Seq Percent=151%

TACTGGCCCGGAGGCTATCCAGCGTANNNCAAAGATTCAGTTTTACTCACGTCATCCAGCAGAGAATGGA	Seq Percent=70%

CATCCGCGGGGAGACCTTGGGCATCATCGGACTTGGTCGCGTGGGGCAGGCAGTGGCGCTGCGGGCCAAGGCCTTCGGCTTCAACGTGCTCTTCTACGACCCTTACTTGTCGGATGGCGTGGAGCGGGCGCTGGGGCTGCAGCGTGTCAG	Seq Percent=150%

GTCCACTGGCGTCTTCACCACCATGGANNAGGCTGGGGCTCATTTGCAGGGGGGAGCCAAAAGGGTCATCATCTCTGCCCCCTCTGCTGACGCCCCCATGTTCGTCATGGGTGTGAACCA	Seq Percent=120%

TTTTTTCTTTCTTCTCTCCCTCTTACTCCCCCTCTTCATTTTTCCTCCCCTCATCCCTCAGCTCCTTTCCGATCTTCAGCTCACACGTCTTCCCTCCCGTCACGTGTTTCTCTCTTCTGCCGTCTTCATCTTGCAAAAAAACCAAACCCA	Seq Percent=150%

GGCTTAATCCAAAGATTCAGGTTTACTCACGTCATCCAGCAGAGAATGGAATCTCGGCAGAGAACACGTCTGAAGTAAAGTCACGTGGGTATCTAGAATGCGGGATTATGCTTGACAAAAAAAAAATAAAGTGATAAAAAAAGGTTAATAA	Seq Percent=151%

CCATTCCTGAAGCTGACAGCCTTCGGNNNGAGATGTCTCGCTCCGTGGTCTTAGCTGTGCTCGCGCTACTCTCTCTTTCTGGCCTGGAGGCTATCCCGCGTACTCCACAGATTCAGGTTTCCTCCCGTCCTCCAGCAGAGAATGGA	Seq Percent=146%

TGATGCCTGGAGGCTATCCAGCGTACTCCAAAGATTCAGGTTTACTCACGTCATCCAGCAGAGAATGGA	Seq Percent=69%

CTGTCTTTCTGGCCTGGAGGCTATCCAGCGTACTCCAAAGATTCAGGTTTACTCACGTCATCCAGCAGAGAATGGA	Seq Percent=76%

TTGCTGGCCTGTAGGCTATCCAGCGTACTCCAAAGATTCATGTTTACTCACGTCATCCAGCAGAGAATGGA	Seq Percent=71%

GACAGCAATCGGGCCGAGATGTCTCGNNNCGTGGCCTTAGCTGTGCTCGCGCTACTCTCTCTTTCTGGCCTGGAGGCTATCCAGCGTACTCCAAAGATTCAGGTTTACTCACGTCATCCAGCAGAGAATGGA	Seq Percent=132%

GTGCCTGGTGGCTATCCAGCGTACNNNNNNNATTCCGTTTTACTCACGTCATCCAGCAGAGAATGGA	Seq Percent=67%

ATTTGGCCTGGAGGCTATCCAGCGTACTCCAAAGATTCAGGTTTACTCACGTCATCCAGCAGAGAATGGA	Seq Percent=70%

GGACTTGGCTGTGCTCGCGCTACTCTCTCTTTCTGGACTGTATGCTATCCAGCGTACTCCAAAGATTCAGGTTTACTCACTTAATCCAGCAGAGAATTGAAGATCGGAAGATCACACGTCTGCAATCAAGTAACGAGATTATATCGTATG	Seq Percent=150%

CTCTTTCTGGACTGTCGGCTATCCAGCGTACTCCAAAGATTCAGGTTTACTCCCGTCATCCAGCAGAGAATGGAAGATAGTAAGAGCACACGTCTGAACACAAGTAAAGATTTTATCTCGTATGAAGACATATGCTTGAAACAAAAAAACA	Seq Percent=151%

NGATTGCGGATTGCGTGGAGCGGGCGCTGGGGCTGCAGCGTTTCAGCACAATGCAGGAGCTTGTCTTTCCCCTCTAATGGGTGACCATGCACTGCGGACTAAACGAGAACAACAACCACCNCATCAACGACTTCACCGTCAAGAAGATGAG	Seq Percent=151%

NTTCCCCCTCTGCTGCTGCCCCCATGTTCTTCATGGGTGTNNCCCACNATCGGACTCGCACCCGTCTGACCTCCCGTCCCGTGTTTATCTCTTATGCCGTCTTCTGCTTGAAAAACCCCANCCCCCACCACAACCCAAAAACAATACTC	Seq Percent=149%

TCACTGGCCTGGAGGCTATCCAGCGTACTCCAAAGCTTCCGGTTTACTCACGTCATCCAGCAGCGAATGGACGATCGGCCGAGCACACGTCTGAACTCCCGTCACGTGTTTATCTCGTATGCCGTCTTCTGCTTGACAAAACAAAACACAA	Seq Percent=151%

GGGCATTTCTGNAGCTGACAGCATTCGGGCCGAGATGTCTCGCTCCGTGGCCTTAGCTGTGCTCGCGCTACTCTCTCTTTCTGGCCTGGAGGCTATCCAGCGTACTCCAAAGATTCAGGTTTACTCACGTCATCCAGCAGAGAATGGA	Seq Percent=148%

AAGAGGATATTGTTGAAATAAATGAAAANTTAATTGAAAAAAAATAAATGGTTTAAATGTTCCAATATGATTAAACACAAGGCAAATTAAATGGCAAGGTAAAGGAGGAGAAAGGTAAGCTGGTAATAAATAGAAATACCATAACCATCTT	Seq Percent=151%

CGGGTCATTCCTGAAGCTGACAGCATTCGGGCCTATATGTCTCTCTCCGTGGCCTTAGCTGTGCTCGCGCTACTCTCTCTTTCTGGCCTGGAGGCTATCCAGCGTACTCCAAAGATTCAGGTTTACTCACGTCATCCAGCAGAGAATGGAA	Seq Percent=151%

TAAGATTCAGGTTTACTCACGTCATCCAGCAGAGAATGTA	Seq Percent=40%

GCCCCCTCTGCTGATGCCCCCATGTTCGTCATGGGTGTGAACCA	Seq Percent=44%

CTGTGCCTGGCGGCTATCCAGCGTACTCCAAAGATTCAGGTTTACTCACGTCATCCAGCAGAGAATGGA	Seq Percent=69%

CTGTGCTCGCGCTACTCTCTCTTTCTGGACTGGAGGATATCCAGCGTACTCCAAAGATTCAGGTTTACTCACGTCATAAAGCAGAGAATGGA	Seq Percent=92%

GGCCCTTGAGGCTATCCAGCGTACTCCNNAGATTCAGGTTTACTCACGTCATCCAGCAGAGAATGGA	Seq Percent=67%

GTATTCCAAAGATTCAGGTTTACTCACGTCATCCAGCAGAGAATGGA	Seq Percent=47%

GAGATTCCTGAAGCTGACAGCATTCGGGCCGAGATGTCTCGCTCCGTGGCCTTAGCTGTGNTCGCGCTACNCTCTCTTTCTGGCCTGGAGGCTATCCAGCGTACTNCAAAGATTCAGGTTTACTCACGTCATCCAGCAGAGAATGGA	Seq Percent=147%

GCCTGGCCTGGAGGCTATCCAGCGTACTACAAAGATACAGGTTTACTCACGTCATCCAGCAGAGAATGGA	Seq Percent=70%

NCTGGCCTGGAGGCCATCCATCGTACTCCAAAGATTCAGGTTTACTCACTTCATCCAGCATAGAATGGA	Seq Percent=69%

ATTCCTGAAGCTGACAGCATTCGGGCCGNGATGTCTCGCTCCGTGGCATAAGCTGTGCTGGGGCTACTCTCTCTTTAGGGCCTGGAGGATATCCAGAGTACTCAACAGATTCCTGTTTACTCACGTCATCCAGCATCTAATGGA	Seq Percent=144%

GGGCATTTCCGAAGCTGACAGCATTCGGGACGAGATGAATAGATAAGTGGACTTAGCTGTGTTCGCGCTACTCTCGATTTATNGCCTGGAGGCTATGANGAGTACTACAAAGATGCAGGNNTAATAACGTCATCCAGAAGAGAATGGANNA	Seq Percent=151%

GATCATGTGGGGCGATGCTGGCGCTGAGTACGTCGTGGAGTCCACTGGCGTCTTCACCACCATGGAGAAGGCTGGGTCTCATTTGCAGTGGGGATCCAAAAGTTTCATCATCTCTGCCCCCTCTGCTGATGCCCCCATGTTCGTCATGGGT	Seq Percent=151%

GATTCCTGAAGCTGACAGCATTCGGGCNNAGATGTCTCGCTCAGTGGACTTAGCTGTGCTAGCGCTACTCTCTCTTAGTGGCCTGGAGGCTATCAAGCGTACTAACACGATGCCGATTTACTCACGTACTCCAGCATAGAATGGA	Seq Percent=145%

TTCTGGCCTGGAGGCTATCCAGCGTACTCCAAAGATTCAGGTTTACTCACTTCATCCAGCAGAGAATGGA	Seq Percent=70%

AAGGGAAAGAGAGGAAGAGAATACTTCTGATCACCAGTCACGTTTCTATCTAGTAAGCCGTATTAGGCATGAAAAACAAAATGATGGAAAAAGCTAAAACATGTAAATGAAATCACCGTCACGATTGAAACCCTCCTAACTGTATGTTTT	Seq Percent=150%

AATAAAGATGATCTGAATAGAACACGTATGAAAGAAAGAAACGGGTATATATCTTAAGACGTATTCGGATTGAAAAAAAAAAAAACAAAAAAAAAAAAAAAAAACATGAAGAAGATAAAAATAAATATACAAAAAAGAGAAGGATATACAA	Seq Percent=151%

NCAATACTTAATCTGACATCATTCGGTCCTAGATGTCTCGCTCCGTGGCCTTAAATTTTCTCGCTCTACTCTCTCTTTCTGGCCTGGAGGCTAACCAGCGTACTCCAAAGATTCAGGTTTACTCACGTCATCCAGCAGAGAATGGA	Seq Percent=146%

TCTCACCAGGTAGGACCTGGAGAAGTTCAAAGCCCTCCGCATCATCGTCCTGATTGGCATNGTTTTTTAANACATCGACATCAAGTCGGCCGGGGATTTAGGCATTGCCGTCTGCAACGTGCCCGCGGCGTCTGTGGAGGAGACGGCCGA	Seq Percent=150%

TTTCAGGCCTGGAGGCTATCCAGCGTACTCCAAAGATTCAGGTTTACTCACGTCATCCAGCAGAGAATGGA	Seq Percent=71%

CATTCTGGCCTGGAGGCTATCCAGCGTNNTCCAAAGATTCAGGTTTACTCACGTCATCCAGCAGAGAATGGA	Seq Percent=72%

CTAGCCTGGAGGCTATCCAGCGTACTCCAAAGATTCATGTTTACTCACGTCANCCAGCAGCGAATGGA	Seq Percent=68%

GCCTAACCCTGCACTGCGGCCTCAACGAGCACAACCACCACCTCATCAACGACTTCACCGTCAAGCAGATGAGACAAGGGGCCTTCCTGGTGAACACAGCCCG	Seq Percent=103%

GTTCCGGCCTGGAGGCTATCCAGCGTACTCCAAAGATTCAGGTTTACTCACGTCATCCAGCAGAGAATGGA	Seq Percent=71%

NGGCATTCCTTAAGCTGACAGCATTCGGGCCGAGATGTCTCTCTAAGTGGACTGAGATGTGATAGCGATAATCTCTATTTCTGGCCTGGAGGCTATCCAGCGTACTCCAAAGATTCAGGTTTACTCACGTCATCCAGCAGAGAATGGA	Seq Percent=148%

GCTGAGAAAGGGAAGATTGTCATCNNNNNNNATCCCATCACCATCTTCCAGGAGCGAGATCCCTCCAAAATCAAGTGGGGCGATGCTGGCGCTGAGTACGTCGTGGAGTCCACTGGCGTCTTCACCACCATGGAGAAGGCTGGGGCTCATT	Seq Percent=151%

TTCTGGCTGGAGGCTATCCAGCGTACTCCAAAGATTCAGGTTTACTCACGTCATCCAGCAGAGAATGGA	Seq Percent=69%

ACATTGACTGAGACACCATGGGGAAGGNNNAGGTCGGAGTCAACGGATTTGGTCGTATTGGGCGCCTGGTCACCAGGGCTGCTTTTAACTCTGGTAAAGTGGATATTGTTGCCATCAATGGCCCCTTCATTGACCTCAACTACATGGTTTA	Seq Percent=151%

TTTTGGCCTGGAGGCTATCCAGCGTACTCCAAAGATTCAGTTTTACTCACGTCATCCAGCAGAGAATGGA	Seq Percent=70%

GAAGCATTCGGGCCGAGATGTCTCGCTCCGTGGCCTTAGCTGTGCTCGCGCTACTCTCTCTTTCTGGCCTGGAGGCTATCCAGCGTACTCCAAAGATTCAGGTTTACTCACGTCATCCAGCAGAGAATGGA	Seq Percent=131%

TTCTGGACTGGAGGCTATCCAGCGTACTAAAAAGATTAAGGTTTACTCACGTCATCCAGCAGAGAATGGA	Seq Percent=70%

ACTCTAAAGATTCATTTTTACTCACTTCATCCAGAAGAAAAGGGAAGAGAGTAATATCACAAGTATGAACTCAAGAAAAGAGTTTAACAGGTATGCAGTAATATGAAGAAAAAAACAAAAAACAAACCACTAAAAACTATACAACAATAAA	Seq Percent=151%

GGCTCGAACTAATCTCTCTTTCTGGCCTGGAGGCTATACAGAGTACACCAAAGATTCAGGTTTAGTCACGTCATCCAGAAGAGAATGGAAGATCGGAAGATAACAAGAATGAAATCCAGTCACGGGTCTATCTCGAAAGCCGAATTCTG	Seq Percent=149%

ATGGCCTGGAGGCTATCCAGCGTACTCCAAAGATTCAGGTTTACTCACGTCATCCAGCAGAGAATGGA	Seq Percent=68%

CGTTCTGGTCTGGAGGCTATCCAGCGTANTCCAAAGATTCAGGTTTACTCACGTCATCCAGCAGAGAATGGA	Seq Percent=72%

TTTTGGCCCGGAGGCTATCCAGCGTACTCCAAAGATTCAGGTTTACTCACGTCATCCAGCAGAGAATGGA	Seq Percent=70%

CTATCTGGGCTGGAGGCTATCCAGCGTACTCCAAAGATTCAGGTTTACTCACGTCATCCAGCAGAGAATGGA	Seq Percent=72%

ATCTCTGGCCTGGAGGCTATCCAGCGTACTCCAAAGATTCAGGTTTACTCACGTCATCCAGCAGAGAATGGA	Seq Percent=72%

GATTCCTGGAGCTGACAGCATTCGGGCCGAGATGTCTCTCTCCGTGGCCTTAGCTGTGCTCGCGCTACTCTCTCTTTCTTGCCTTGAGTCTATCCAGCTTACTCCAAAGATTCAGTTTTACTCACGTCATCCANCAGAGANTGTA	Seq Percent=145%

GACCCTTACTTGTCGGATGGCGTGGANNNGGCGCTGGGGCTGCAGCGTGTCAGCACCCTGCAGGACCTGCTCTTCCACAGCGACTGCGTGACCCTTCACTGCGGCCTCAACGAGCACAACCACCACCTCATCAACGACTTCACCGTCAAG	Seq Percent=150%

GGGGCATTCCTGAAGCTGACAGCATTCGGGCCGAGATGTCTCGCTCCGTGGCCTTAGCTGTGCTCGCGCTACTCTCTCTTTCTGGCCTGGAGGCTATCCAGCGTACTCCAAAGATTCAGGTTTACTCACGTCATCCAGCAGAGAATGGAAG	Seq Percent=151%

CCCGCACGCAGTTTTATCCGGTAAAGCGAATGATTAGAGGTCTTGGGGCCGAAACGATCTCAACCTATTCTCAAACTTTAAATGGGTAAGAAGCCCGGCTCGCTGGCGTGGAGCCGGGCGTGGAATGCGAGTGCCTAGTGGGCCACTTTTG	Seq Percent=151%

GAGGCATTCCTGAAGCTGACAGCATTCGGGCCGAGATGTCTCGCTCCGTGGCCTTAGCTGTGCTCGCGCTACTCTCTCTTTCTGGCCTGGAGGCTATCCAGCGTACTCCAAAGATTCAGGTTTACTCACGTCANCCAGCAGAGAATGGAAG	Seq Percent=151%

CTCGCTGGGAAGTGGAGCCTTTGGAGAAGTGTATGAAGGAACAGCAGTGGACATCTTAGGAGTTGGAAGTGGAGAAATCAAAGTAGCAGTGAAGACTTTGAAGAAGGGTTCCACAGACCAGGAGAAGATTGAATTCCTG	Seq Percent=139%

TACCTTACTTGTCGGATGGCGTGGAGNNNNNGCTGGGGCTGCAGCGTGTCAGCACCCTGCAGGACCTGCTCTTCCACAGCGACTGCGTGACCCTGCACTGCGGCCTCAACGAGCACAACCACCACCTCATCAACGACTTCACCGTCAAGCA	Seq Percent=151%

AAATCCCATCACCATCTTCCAGGAGCGAGATCCCTCCAAAATCAAGTGGGGCNATTCTGGNGCTGATTACNTCGTGGNGTCCACTGGCGTCTTCACCACCATGGANAAGGCTGGGGCTCATTTGCAGGGGGGAGCCAAAAGGGTCATCAT	Seq Percent=150%

GGGGCATTCCTGAAGCTGACAGCATTCGGGCCGAGATGTCTCGCTCCGTGGCCTTAGCTGTGCTCGCGCTACTCTCTCTTTCTGGCCTGGAGGCTATCCNGCGTACTCCAAAGATTCAGGNTTACTCACGTCATCCAGCAGAGAATGGAAG	Seq Percent=151%

CTTTACGGCCTGGAGGCTATCCAGCGTNNTCCAAAGATTCAGGTTTACTCACGTCATCCAGCAGAGAATGGA	Seq Percent=72%

TTCTGGCCTGGAGGCTATCCAGCGTACTCCAAAGATTCAGGTTTACTCACGTCATCCAGCCGAGAATGGA	Seq Percent=70%

CTCCAAACTCAAGTGGGGCGATGCTGGCGCTGAGTACGTCGTGGAGTCCACTGGCGTCTTCACCACCATGGAGAAGGCTGGGGCTCATTTGCAGGGGGGAGCCAAAAGGGTCATCATCTCCGCCCCCTCTGCTTATGCCCCCATTTTCGT	Seq Percent=150%

TTCTTGCCCGGAGGCTATCCAGCGTACNNCAAAGATTCAGGTTTACTCACGTCATCCAGCCGAGAATGGA	Seq Percent=70%

ACTCTGGCCTGGAGGCTATCCAGCGTACTCCAAAGATTCAGGTTTACTCACGTCATCCAGCAGAGAATGGA	Seq Percent=71%

GGCCTGAAGGCTATCCAGCGTACTCCAAAGATTCAGGTTTACTCACGTCATCCAGCCTAGAATGGCAGATCTGAATAGCACACGTCTAAACTACAGTCACGTGTTTATCTCTTATGCCGTCTTCTGCTTGAAAAAAAAAAAAAAAAATAAT	Seq Percent=151%

GATTCCTAAAGCTGACAGCATTCGGGCCGAGATGTCTCGCTCCGTGGCCTTAGCTGTGCTCGCGCTACTCTCTCTTTCTGGCCTGGAGGCTATCCAGCGTACTCCAAAGATTCAGGTTTACTCACGTCATCCAGCAGAGAATGGA	Seq Percent=145%

GGGGCATTCCTGAAGCTGACAGCATTCGGGCCGAGATGTCTCGCTCCGTGGCCTTAGCTGTGCTCGCGCTACTCTCTCTTTCTGGCCTGGAGGCTATCCAGCGTACTCCAAAGATTCAGGTTTACTCACGTCATCCAGCAGAGAATGGAAG	Seq Percent=151%

TAACAGGTTTACAAAAGAAATCCAGCAGAGAATGGA	Seq Percent=36%

ACTAGTGAACCTGCACTGCGGCCTCAACGAGCACAACCACCACCTCATCAACGACTTCACCGTCAAGCAGATGAGACAAGGGGCCTACCTGGTGAACACAGCCCG	Seq Percent=105%

GGCTTCCTGAAGCTGACAGCATTCGGNNNGNGATGTCTCGCTCCGTGGCCTTAGATGTGCTCGCGCAACTCTCTCTTTCTGGCCTGGAGGCTATCCAGCGTACTCCAAAGATTCAGTTTTACTCACGTCAGCCAGCAGAGAATGTA	Seq Percent=146%

AAAAAAATAAAACAAAACACAACAACAGAAAACCACCAAAAGAAACGATCACAACAGCAAACAAATGGAAAGAAAGAAAAAAACACAAAAAGAGAAAAAAAAACAAAACAAAGAACCAAGAAAGATAGAGAAATAAAGCGATACCACTAAT	Seq Percent=151%

CTTCCCCCTCTGCTTATTCCCCCATGTTCGTCATGGGTGTGAACCA	Seq Percent=46%

ACTCCAAAGATTCAGGTTTACTCACNNNNNCNAGCAGAGAATGGA	Seq Percent=45%

ATAGAAGGAAAGGAGGCAAGAAAGAGAAATAAAAATATAAAGGTTAAAAAACGTCATCCAGCAGAGAATGGAAGAACGGAAGAGCAAAAGTCTGAACACCAGTCACGTGTTTATATCGTATGCCGTCTTCTGCTTGAAAAAAAAAAAAAAA	Seq Percent=151%

ATGGGAAAAAAGGAAGCAGAAAGAATTAGGGACGATATGTATCGCAAAGTGGCCTTAGCTGTGCTCGCGCTACTAACTCTATCTGGAAAGGAGGCTAACCAGCGTCCTCCAAAGATTCAGGTTTACTCACGTCATCCAGCAGAGAATGGAA	Seq Percent=151%

CGCCAGGCGAGCCACATCGCTGAGACACCATGGGGAAGGTGAAGGTCGGAGTCAACGGATTTGGTCGTATTGGGCGCCTGGTCACCAGGGCTGCTTTTAACTCTGGTAAAGTGGATATTGTTGCCATCAATGACCCCTTCATTGACCTCAA	Seq Percent=151%

TGGGCCTGGAGGCTATCCAGCGTACTCCAAAGATTCAGGTTTACTCACGTCATCCAGCAGAGAATGG	Seq Percent=67%

CTGACTGGCCCGGAGGCTATCCAGCGTACTCCAAAGATTCAGGTTTACTCACGTCATCCAGCAGAGAATGGAAGATAGGAANAGCAAACGTCTGAAATNNAGACAAGAGAGNAGCTCGTNNGCCGTCCTCTGCTTNNAAAAAGGAAAANNA	Seq Percent=151%

GGGTCATGCCTGAAGCTGACAGCATTCGGGCCTCTATGTCTCGCTCCGTTGCCTTATCTGTTCTCTCTCTACTCTCTCTTTCTGGCCTTTCTGCTATCCAGCGTACTCCAAAGATTCAGGTTTACTCACGTCATCCAGCAGAGAATGGAAG	Seq Percent=151%

GGCTTGGTGGCTATCCAGCGTACTCCANNTATTCAGGTTTACTCACGTCATCCAGCAGAGAATGGA	Seq Percent=66%

AGGCATTCCTGAAGCTGACAGCATTCGGGCCGAGATGTCTAGAAAAGAGGACTTAGCTGTGCGCGCGCTACTCTCTAATGATGGCCAGGAGGCTAAAAAGCGTAATCCAAAGATACAGGTTTACTCACGTCATCCAGCCGAGAATGGA	Seq Percent=148%

CACAACCACCACCTCATCAACGACTTCACCGTCAAGCAGATGAGACAGGGGGCCTTCCTGGTGAACACAGCCCG	Seq Percent=74%

GGCCTTGAAGCCTAGGTCGCGGGCCCGGGTGTCTCCGCCGCAGTTTCAGCTCTTGGTTTTATTCGCCCCTATTCACACGATAACTTTGCCGTCCGAAGTGAAGAAGGGTTCCAACGACCAGGAGAAGATTGAATTCCTG	Seq Percent=139%

ATTTCTGGCCTGGAGGCTATCCAGCGTACTCCCCCGATTCAGGTTTACTCACGTCATCCAGCCTATCCTGGACGATCGGACGAGCACACTTCTTAACTCCAGTCACGTGTTTATCTCGTATGCCGTCTTCTGCTTGAAAAAAAAAAAA	Seq Percent=148%

AGGGCATTCCTGAAGCTGACAGCATTCGGGCCGAGATGTAGAAAAAAGTGGCCTTAGTAGGGATCGCGCTACTCTAAATTACTGGCAGGTAGGCGAGACCGCGAACTCCAAAGCATCAGGTTTACTCACGTCATCCAGCAGAGAATGGCAG	Seq Percent=151%

TGCTGGGAGGTGGAGCCTTTGGAGAAGTGTATGAAGGAACAGCAGTGGGCATCTTAGGAGTTGGAAGTGGAGAAATCAAAGTAGCAGTGAAGACTTTGAAGAAGGGTTCCACAGACCAGGAGAAGATTGAATTCCTG	Seq Percent=137%

TTCTGGCCTGGAGGCTATCCAGCGTACTCCAAAGATTCAGGTTTACTCACGTCATCCAGCAGAGAATGGA	Seq Percent=70%

CGGGACCAACTGACTCTGCGTCTCTTGCTGGGAAGTGGAGCCTTTGGAGAAGTGTATGAAGGAACAGCAGTGGACATCTTAGGAGTTGGAAGTGGAGAAATCAAAGTAGCAGTGAAGACTTTGAAGAAGGGTTCCACAGACCAGGAGA	Seq Percent=148%

TTGTGGCCTGGAGGCTATCCAGCGTACTCCAAAGATTCAGGTTTACTCACGTCATCCAGCAGAGAATGGA	Seq Percent=70%

TCCATGGCCTGGAGGCTATCCAGCGTACTCCAAAGATTCAGGTTTACTCACGTCATCCAGCAGAGAATGGA	Seq Percent=71%

ATACTGGCCTGNAGGCTATCCAGCGTACTCCAAAGATTCAGGTTTACTCACGTCATCCAGCAGAGAATGGG	Seq Percent=71%

GCGAGCTCCCTCCAAAATCAAGTGGGGCGATGCTGGCGCTGAGTACGTCGTGGAGTCCACTGGCGTCTTCACCACCATGGAGAAGGCTGGGGCTCATTTGCAGGGGGGAGCCAAAAGGGTCATCATCTCTGCCCCCTCTGCTGATGCCCC	Seq Percent=150%

TTGGATGGCGTGGAGCGGGCGCTGGGGCTGCAGCGTGTCAGCACCCTGCAGGACCTGCTCTTCCACAGCGACTGCGTGACCCTGCACTGCGGCCTCAACGAGCACAACCACCACCTCATCAACGACTTCACCGTNAAGCANATGAGACAAN	Seq Percent=151%

TTTTGGCCTGGAGGCTATCCAGCGTACTCCAAAGATTCAGGTTTACTCACGTCATCCAGCAGAGAATGGA	Seq Percent=70%

GAGAACGGGAAGCTTGTCATCAATGGAAATCCCATCACCATCTTCCAGGAGCGAGATCCCTCCAAAATCAAGTGGGGCGATGCTGGCGCTGAGTACGTCGTGGAGTCCACTGGCGTCTTCACCACCATGGAGAAGGCTGGGGCTCATTTG	Seq Percent=150%

AAAGGGCACCAATCAAACAATAACAAAAACAACGTCACATAAAAAAAACACACCCAAAATTCATACACAGGCCAAAATATACTGAAAAATTCCTCTGANACAATATCAAAACAAAATACNNAAACAAAAAAAAGACAAACATACAAAANCA	Seq Percent=151%

GTTTCATTCCTTAATCTTACATCATTCTTTCCTAGATGTCTCGCTCCGTGGCCTTATCTGTTCTCTCTCTACTCTCTCTTTNTGGCCTGGAGGCTATCNNGCGTACTCCAANGATTCAGNNTTACTCACGTCATCCAGCAGAGAATGGNAG	Seq Percent=151%

NGGGCATTCCTGAATCTGACAGCATTCGGGCCTATATATCTCGCTCCGTTTCCTTATCTTTGCTCGCGCTACTCTCTCTTTCTGGCCTGGATGCTATCCAGCGTACTCCAAAGATTCAGGTTTACTCACGTCATCCAGCAGAGAATGGAAG	Seq Percent=151%

GGTCTGGAGGCTATCCAGCGTACTCCAAAGATTCAGGTTTACCCACGTCATCCAGCAGAGAATGGA	Seq Percent=66%

TTTGGCCGGAGGCTATCCAGCGTACTNNNAAGATTCAGGTTTACTCACGTCATCCAGCAGAGAATGGA	Seq Percent=68%

CGGGGGTCGCGTAACTAGTTAGCATGNNNNNGTCTCGTTCGTTATCGGAATTAACCAGACAAATCGCTCCACCAACTAAGAACGGCCATGCACCACCACCCACGGAATCGAGAAAGAGCTATCAATCTGTCAATCCTGTCCGTGTCCGGG	Seq Percent=150%

CAGTGGGGCGATGCTGGCGCTGAGTACGTCGTGGAGTCCACTGGCGTCTTCACCACCATGGAGAAGGCTGGGGCTCATTTGNNGGGGGGAGCCAAAAGNNTCATCATCTCTNNNCCCTCNNCTGATGNCCNCATGNNNGTCATGGGNNNNA	Seq Percent=151%

TTTCCTTGGCTGTGCTCGCGCTACTCNNNCTTTCTGGCCTGGAGGCTATCCATCGTACCCCAAAGATTCAGGTTTACTCACGTCATCCAGCAGAGAATGGA	Seq Percent=101%

CACGTCATCCATCAGAGAATGTAAGATCTTAAGATCACACGTCTTAACTCCAGTCACGTTTTTATCTCGTATGCCGTCTTCTGCTTGAAAAAAAAAAAAAAAATAAAAAGAAAAGAATACTATTATAAAGATTGAAAAAGCAGACGCTAAA	Seq Percent=151%

TTTCTGAGCCTGGATGCTATCCAGCGTACTCCAAAGATTCAGGTTTACTCACGTCATCCAGCAGAGAATGGA	Seq Percent=72%

GACGGCCGACTCGACGCTGTGCCACATCCTGAACCTGTACCGGCGGGCCACCTGGCTACACCAGGCGCTGCGGGAGGGCACNCGAGTCCAGAGCGTCGNNCAGATCCGCGANGTGGCGTNNGGCGCTGCCAGGATCNGCGGGGAGACCNTT	Seq Percent=151%

TGGGCATTCCTGAAGCTGACAGCATTCGGGCCGAGATGTCTCGATACGTGGACTTAGCTGGGATCGAGCAAATATCTATAACTGGCATGGAGGATACACAGCTAACTCCAACTCATCAGGTTTACTACCATCATACCTCAGATAAATTA	Seq Percent=149%

CTGGCGCTAAGTACGTCGTGGAGTCCACTGGCGTCTTCACCACCATGGAGAAGGCTGGGGCTCATTTGCAGGGGGGAGCCAAAAGGGTCATCATCTCTGCCCCCTCTGCTGATGCCCCCATGTTCGTCATGGGTGTGAACCA	Seq Percent=142%

CGTCTTGTCGGATGTCGTGGAGCGGGNNNNNGGGCTGCAGCGTGTCAGCACCCTGCAGGACCTGCTCTTCCACAGCGACTGCGTGACCCTGCACTGCGGCCTCAACGAGCACAACCACCACCTCATCAACGACTTCACCGTCAAGCAGATG	Seq Percent=151%

TTCTGGCCTGGAGGCTATCCAGCGTACTCCAAAGATTCAGGTTTACTCACGTCATCCAGCAGAGAATGGAAGATCGGAAGANCACACGTCTGAACTCCNNACACGTGTTTANCTCGTATNNCGTCTTCTGCTTGAANAAAAAAAAAAANAA	Seq Percent=151%

AAGCGAATGCGTGACCCTGCACTGCGGCCTCAACGAGCACAACCACCACCTCATCAACGACTTCGCCGTCAAGCAGATGAGACAAGGGGCCTTCCTGGTGAACACAGCCCG	Seq Percent=111%

TTCTAGCCCGGAGGCTATCCAGCGTACTCCAAAGATTCAGGTTTACTCACGTCATCCAGCAGAGAATGGA	Seq Percent=70%

GATCATGCCTGGAGGCTATCCAGCGTANTCCAAAGATTCAGGTTTACTCACGTCATCCAGCAGAGAATGGA	Seq Percent=71%

TTCTGGCCAGGAGGCTATCCAGCGTANNNCAAAGATTCAGGTTTACTCACGTCATCCAGCAGAGAATGGA	Seq Percent=70%

GGGCATTCCTGAAGCTGACAGCATTCGGGCCGAGATGTCTCGCTCCGTGGCCTTAGCTGTGCTCGCGCTACTCTCTCTTTCTGGCCTGGAGGCTATCCAGCGTACTCCAAAGATTCAGGTTTACTCACGTCATCCAGCAGAGAATGGA	Seq Percent=148%

TACTGTGCTCGCGCTACTCTCTCTNNNNNNNCTGGAGGCTATCCAGCGTACTCCAAAGATTCAGGTTTACTCACGTCATCCAGCAGAGAATGGA	Seq Percent=94%

TTCCCATGGAGGCTATCCAGCGTACTCNNAAGATTCAGGTTTACTCACGTCATCCAGCAGAGAATGGA	Seq Percent=68%

TGCATTCCTGAAGCTGACAGCATTCGGGCCGAGATTTCTCGCCCCGTGGCCTTAGCTGAGCTCGCGCTACACTCTCTTTCTTGCCTTTATGCTACCCAGCTTACTCCACAGATTCAGGTTTACTCACGTCATCCAGCAGAGAATGGA	Seq Percent=147%

TCTCTGGACTGGAGGCTATCCAGCGTACTCCCCATATTAAGGTTTACTAACTTCATCCCTCCTCGCCTTTCCTATAGGAAGAGCACAAGCCGGCACTCCAGTCAAGTGTTCATATCGTATGCCGTCTTATGCTTGAAAAAAAAAAAGAAAA	Seq Percent=151%

GGGCATTCCTGAAGCTGACAGCAATCGGGCCGAGATGTCTCGCTCCGTGGCCTTAGCTGTGCTCGCGCTACTCTCTCTTTCTGGCCTGGAGGCTATCCAGCGTACTCCAAAGATTCAGGTTTACTCACGTCATCCAGCAGAGAATGGA	Seq Percent=148%

GACGACCCTTACTTGTCGGATGGCGTNNNGCGGGAGCTGGGGCTGAAGAGTGTCAGCACCCTGCAGGACCTGCTCTTCCACAGCGACTGCGTGACCCTGCACTGCGGCCTCAATGAGCACAACCACCACCTCATCAACGACTTCACCGTCA	Seq Percent=151%

TGGGCGATGGGGCTGCAGCGTGTCATCACCCTTCAGGAACTGCTCTTAAACCGCGACTTCTTTCACCTTCCCTGCGGAATCACCGAGAACAAACACAACCTCATAAACGACTTAACCGTCAAGCAGATGAGACAAGGGGCCTTCCTGGTGA	Seq Percent=151%

CTTCTGGCCTGGAGGCTATCCAGCGTACTCCAAAGATTCAGGTTTACTCACGTCATCCAGCAGAGAATGGA	Seq Percent=71%

GGGGCATTCCTGAAGCTGACAGCATTCGGGCCTAGATGTCTCGCTCCGTGGCCTTAGCTTTTCTCGCTCTCCTCTCTCTTTCTGGCCTGTCTTCTCTCCAGCGTACTCCAAAGATTCAGGTTTACTCACGTCATCCAGCAGAGAATGGAAG	Seq Percent=151%

GCTTTCTTGCCTGGAGGCTATCCAGCGTACTCCAAAGATTCAGGTTTACTCACGTCATCCAGCAGAGAATGGA	Seq Percent=73%

GGTGCCAACAAAGACCCCTTCATTGACCTCACCGACATGGAATAGAAGGGGCTCTATGAAACAAACCCTGGCAAATTCCATGGCACCGTCAAGGAGGAGAACGGGTAGCTTGTCATCCATGGAAATCCCATCACCATCTTCCAGGATCGAT	Seq Percent=151%

TTTTCTGGCCTGGAGGCTATCCAGCGTNNTCCAAAGATTCAGGTTTACTCACGTCATCCAGCAGAGAATGGA	Seq Percent=72%

GCGGGCGCTGGGGCCGCAGCGTGTCAGCACCCTGCAGGACCTGCTCTTCCACAGCGACTGCGTGACCCTGCACTGCGGCCTCAACGAGCACAACCACCACCTCATCAACGACTTCACCGTCAAGCAGATGAGACAAGGGGCCTTCCTGGTG	Seq Percent=151%

CTCTTTCAGGCCTGGAGGCTATCCAGCGTACTCCAAAGATTCAGGTTTACTCACGTCATCCAGCAGAGAATGGA	Seq Percent=74%

CAAGCTGTGCTCGCGCTACTCTCTCTTTCTGGCCTGGAGGCTATCCAGCGTACTCCAAAGATTCAGGTTTACTCACGTCANNNAGCAGAGAATGGAAGNNCGGAAGAGCACNCNTCTGANNTCCAGTCNCNTGTTNNTCTCGTATGCCNN	Seq Percent=150%

GCTTTCCTGAAGCTGACATCATTCGGGCCGAGATGTCTCGCTCCGTGGCCTTAGCTGTGCTCGCGCTACTCTCTCTTTCTGGCCTTGAGGCTATCCAGCGTACTCCAAAGATTCAGGATTACTCAAGTCATCCACCAGATAATGGA	Seq Percent=146%

AAATTGGAATGGAGGCTATCCATCTTACTCCAAAGATTCAGGTTTACTCACGTCATCCAGCAGAGAATGGA	Seq Percent=71%

CTGCGCTGGCCTGGAGGCTATCCAGCGTACTCCAAAGATTCAGGTTTACTCACGTCATCCAGCAGAGAATGGA	Seq Percent=73%

GCTGGCCTGGAGGCTATCCAGCGTACTCCAAAGATTCAGGTTTACTCACGTCATCCAGCAGAGAATGGA	Seq Percent=69%

GGATGCATGAAGATGACAGCATTCTTGCCGTTATGTCTCGCTCCGTGGCCTTCGCTGTGCTCGCGCTACTCTCTCTTGCTGNCCTGGAGGCTATCCAGNNGACTCAAAAGANAAAGGTTNNCTCACGTCATCCAGCNCAGAAAAGAAGNT	Seq Percent=150%

TTGGGGCGATGCTGGCGCTGAGTACGTCGTGGAGTCCACTGGCGTCTTCACCACCATGGAGAAGGCTGGGGCTCATTTGCAGGGGGGAGCCAAAAGGGTCATCATCTCTGCCCCCTCTGCTGACGCCCCCATGTTCGTCATGGGTGTGAA	Seq Percent=150%

CTCTGGCCTGGNGGCTATCCAGCGTACTCCAAAGATTCAGGTTTACTCACGTCATCCAGCAGAGAATGGA	Seq Percent=70%

GGATTCCCAAATAAACCAGGCATTCCCAAATTACTAG	Seq Percent=37%

GCTTTCCTGAAGCTGACAGCATTCGGGCCGAGATGTCTCGCTCCGTGGCCTTAGCTGTGCTCGCGCTACTCTCTCTTTCTGGCCTGGAGGCTATCCAGCGTACTCCAAAGATTCAGGTTTACTCACGTCATCCAGCAGAGAATGGA	Seq Percent=146%

ATTTCTGACCTGGAGGCTATCCAGCGTACTCCAAAGATTCAGGTTTACTCACGTCATCCAGCAGAGAATGGA	Seq Percent=72%

CGCCTTAGCTGTGCTCGCGCTACTCTNNNTTTCTGGCCTGGAGGCTATCCAGCGTACTCCAAAGATTCAGGTTTACTCACGTCATCCAGCAGAGAATGGN	Seq Percent=100%

TCCGCACATGAACGGGCCCCTGCACCCGCGGCCCCTGGTGGCATTGCTGGATGGCCGGGACTGCACAGTGGAGATGCCCATCCTGAAGGACGTGGCCACTGTGGCCTTGTGCGACGCGCAGTCCACGCAGGAGATCCATGAGAAGGGC	Seq Percent=148%

TCTCCTCCAAAATCAAGTGGGGCGATGCTGGCGCTGAGTACGTCGTGGAGTCCCCTGTCGTCTTCCCCCCCATGGAGAAGGCTGGGGCTCATTTGCAGGGGGGAGCCAAAAGGGTCATCATCTCTGCCCCCTCTGCTGATGCCCCCATGTT	Seq Percent=151%

GGACTGGTGGCTATCCAGCGTACTCCAAAGATTCAGGTTTACTCACGTCATCCAGCAGAGAATGGA	Seq Percent=66%

CGGGACAAACTGACTCTGCGTCTCTTGCTGGGAAGTGGAGCCTTTGGAGAAGTGTATGAAGGAACAGCAGTGGACATCTTAGGAGTTGGAAGTGGAGAAATCAAAGTAGCAGTGAAGACTTTGAAGAAGGGTTCCACAGACCAGGAGA	Seq Percent=148%

CCATTCTGGCCTGGAGGCTATCCAGCGTACTACAAAGATTCAGGTTTACTCACGTCAACCAGCAGAGAATGGA	Seq Percent=73%

TGGCCTTAGCTGTGCTCGCGCTACTCTCTCTTTCTGGCCTGGAGGCTATCCAGCGTACTCCAAAGATTCTGTTTTACTCACGTCATCCAGCAGATAATGGA	Seq Percent=101%

GTTCTGGCTTGGAGGTTATCCAGCGTNNNCCAACGATTTATTTTTCCTCACGTAATCCAGAAGAGAATGGA	Seq Percent=71%

TTTTATACCATAAACAATTTTCATACTTACTATTATAGTTGGAATATTTCTGGTTGTTACAATCCCACTGACCTTTGTCTGGCATAGAAGATTAGAGAATCAAAAAAGTGCCAAGGAAGGGGTG	Seq Percent=124%

ATCTCACCATATCTTAATAGCACACGTCTGAACTCCAGTCACGTGTTTATCTCGTATGCCGTCTTCTGCTTGAAAAAAAAAAAAAAAAAAAAAAAAATGTCTACAGACATCACAATATAAAAAAAAACAAAGATGAAAACATATATAAAAA	Seq Percent=151%

CTTCTGGCCTGGAGGCTATCCAGCGTNNNCCAACGATTTAGTTTTCCTCACGTAATCCAGAAGAGAATGGA	Seq Percent=71%

CTTCTGTCCTGGAGGCTATCCAGCGTACTCCAAAGATTCCGTTTTACTCACGTCATCCAGCAGCGAATGGA	Seq Percent=71%

TTTCCTTCTCTCTTAAGCTCCCACGTCCTCACTCCAGTCACGTGTTTCTCTCGTATGCCGTCTTCTGCTTGAAAATAAAAATGTCCTGTAGTCTCTCCCGCTTACTCCCCATCTTCCTGTTTCCTCCCTTCCTCCATCCGCTCATTGCCGA	Seq Percent=151%

TAGCCTGGAGGCTATCCAGCGTACTCCAAAGATTCAGGTTTACTACCGTCATCAAGCAGAGAATGGA	Seq Percent=67%

CTAAGCCCTCTGATGATGCAAAAAAGATAGAAATGGGTGTGAACCA	Seq Percent=46%

CTTTTTTATTATCAAATATTCAAACGNNNNNTTTAGGAGCCTGCGACTTTGGAAGGGAGAGGGTCGAGATAAGGCTCGGACGAGCACACGTCTGGACTCCAGTCACGTGTTTATCTCGTATGCCGTCGTCTGCTTGAAAAAAAAAAAAAAA	Seq Percent=151%

CGCACTTCGGCCCCAACGAGCACAACCACCACCTCATCCCCGACTTCCCCTAAAAGCAGATGAGCCAAGGGTACTACCTGTTGAACACAGCCCG	Seq Percent=94%

ATTCTGTCCTGGAGGCTATCCAGCGTACTCCAAAGATTCAGTTTTACTCACGTCATCCATCATAGAATGGA	Seq Percent=71%

GTTTGGAGATGATGGCGATGAGTACTNNNTGGAGTCCACTGGCGTCGTCACAACCAGGGAGAAGGATGGGGATAATTTGCAGGGGGGAGAAAAAAGGGTCATCATCTCTGCCCCCTCTGCTGACGCCCCCATGTTCGTCATGGGTGTGAA	Seq Percent=150%

TGAGAAGGAAGAGAACAAGTCTGAACTCCAATAACGTGTTTATATCGTATGACGACAAAAGAAGGAAAAAAAAAACAAAAAACATATAAAAAAATGTAAGATTACATAATAAAAAAAAAAAAAAAACATAAACAAAAAAAACAATCACAT	Seq Percent=150%

TACGACGCTTACTTGTCGGATGGCGTGGAGCGGGCGCTGGGGCTGCAGCGTTTCATCACCCTGCATTACCTTCTCTTCCACAGCGACTGCTTTACCCTGCACTGCGGCCTCAACGAGCACAACCACCACCTCATCAACGACTTCACCGTCA	Seq Percent=151%

ATATGGAATGGAGGATATAAAGCGTANNNNAAAGATTCAGGTTTACTCACGTCATCAAGAAGAGAATGGA	Seq Percent=70%

TTGGCCTGGAGGCTATCCAGCGTACTCNNAAGATTCAGGTTTACTCACGTCATCCAGCAGAGAATGGA	Seq Percent=68%

AGATTCCTGAAGCTGACAGCATTCGGGCCGAGATGTCTNNCNCCGTNNNCTTAGCTGTGCTCGCGCTACTCTCTCTTTCTNNNCTGGAGGCTATCCAGNNTACTCCAAAGANTNAGGTTNNCTCACGNNANCCATNNNAGAATGGANNNNT	Seq Percent=151%

CTTTCTGGCCTGGAGGCTATNCAGCGTACTCCAAAGATTCAGGTTTACTCACGTCATCCAGCAGAGAATGGA	Seq Percent=72%

GTATAAAAGATAGGAAGAGAAAAAGTATGAAATCCAGTCACGTTTTTATCTAGAAAGACTTATTATGATTGAAAACAAAAAAAATAAAAAAAAGATAATATAATTTTAGAATATCAATAAAAAAACAAAAAGAAAAAGAATATAAAATAAA	Seq Percent=151%

CATCACCGTCTTCCAGGAGCGAGATCCCTCCAAAATCAAGTTGGTCGANGCTGGCGCTTATTACTTCTTTTATTCCACTGNNNTCTTCACTACCATGGNNAAGGCTGGGGCNCNTTTGCNNGGGGGAGNCNAAAGNNTCATCATCTCNNN	Seq Percent=150%

GACAGTATTCGTGCCGAGATGTCTCGCTCCGTGGCCTTAGCTGTTCTCGCGCTACTCTCTCTTTCTGTCCTGTATGCTATCCAGCGTACTCCAAAGATTCAGGTTTACTCACGTCATCCAGCAGAGAATGGA	Seq Percent=132%

AAACACCAGACACGTCTTGTAACACGGACCAAGGAGTCTAAAACGTGCGCGAATCGGGAAAAAGAACGAAAGAAGCCGTGGCGCACTGAAAAAGCACGCCGGCGCGCTCGCCGGCCGAGGTGAGATCCCTCCAAAATCAAGTGGGGCGATT	Seq Percent=151%

ATGCTGGACTGGAGGCTATCCAGCGTACTCCAAAGATTCAGGTGTAATCACGTCATCCAGAAGAGAATGGA	Seq Percent=71%

GGGGCAAACCTGAAGCTGACAGCATTNNNGCCGAGATGTAAAGGACAGTGGCCTTAGCTGAGATAGCGCAACACACTCTTTCTGGCCTGGAGGCTATCCAGCGTACTCCAAAGATTCAGGTTTACTCACGTCATTCAGCAGAGAATGGAAG	Seq Percent=151%

TAGCGAGGTGGAGTCCGGCGATGCCAGGATCCGCGGGGAGACATTGGGCATCATCGGACTTGGTCGCGTGGGGCAGGAAGTGNCGCTGCGGGCCAAGGNNTTCGGCTTCACATAGCTCTNNTACGACCCTNACTTNNCGGATGGCGTNNNG	Seq Percent=151%

GATTCCTGAAGCTGACAGCATTCGGGCCGAGATGTATAGCTCATTGGNCTTAGCTGTGCTCTCGCTACTCTCTCTATCTGGACTGGAGGCTATCCAGAGCACTCAAAAGAGTAAGTTTTACTCAAGTCATCCAGCAGAGAATGGA	Seq Percent=145%

CACTTAAGGTAGCCAAATGCCTCGTCATCTAACAAGTGACGCGCATGAAAGGATGAACTATATTCCCACTTTCCCTACAAAATATCAAGCGAAACCAAAGAAAAGGGAAAGGGAATGGCGGACAAAGCGTGGAAAAAAGACCAAGTTGAG	Seq Percent=150%

CTCTCTTTCTGTCCTGGAGGCTATCCAGCGTACTCCAAAGATTCAGGTTTACTCACGTCATCCAGCAGAGAATGGA	Seq Percent=76%

GGGCATTCGTGAAGCTGACAGCATTCGGGCCGAGATGTCTCGCTCCGTGGCCTTAGCTGTGCTCGCGCTACTCTCTCTTTCTGGCCTGGAGGCTATCCATCTTACTCCAAAGATTCAGGNNCACTCACTTCATCCAGCAGAGAATGGANGA	Seq Percent=151%

TTCTGGCCTGGAGGCTATCCAGCGTACTCCAAAGATTCAGGTTTACTCACGTCATCCAGCAGAGAATGGA	Seq Percent=70%

AACTGGCGCCTGCACCCGCGGCCCCTGGTGGCATTGCTGGATGGCCGGGACTGCACAGTGGAGATGCCCATCCTGAAGGACGTGGCCACTGTGGCCTTCTGCGACGCGCAGTCCACGCAGGAGATCCATGAGGAGGTCCTGAACGGGGCNG	Seq Percent=151%

NTAACTGTCGGATGGCGTGGAGCGGGCGCTGGGGCTGCAGCGTGTCAGCACCCTGCAGGACCTGCTCTTCCACAGCGACTGCGTGACCCTGCACTGCGGCCTCAACGAGCACAACCACCACCTCATCAACGACTTCACCGTCAAGCAGATG	Seq Percent=151%

CTTGACTGATGGCGTGGAGCGGGCGCTGGGGCTGCAGCGTGTCAGCACCCTGCAGGACCTGCTCTTCCACAGCGACTGCGTGACCCTGCACTGCGGCCTCAACGAGCACAACCACCACCTCATCAACGACTTCNCCGTCAAGCAGATG	Seq Percent=148%

GACCCCCAAGATCGGAAGAGCACACGNNNGNACTCCAGTCACGTGTTTATCTCGTATGCCGTCTTCTGCTTGAAAAAAAAAAAAAAAAAAAAAAAAAATAAAAAAAATTATTATAAAAAAAAGAGAGAAATAGGATGCATGAAAAAAGACA	Seq Percent=151%

NTGCCCCCTCTGCTGACGCCCCCATGTTCGTCATGGGTGTGAACCA	Seq Percent=46%

CTTTTATGGCCTGGAGGCTATCCAGCGTACTCCAAAGATTNAGGTTTNCTCACGTCATCCAGCAGAGAATGGA	Seq Percent=73%

CAATGACCCCTTCATTGACCTCAACTACATGGTTTACATGTTCCAATATGATTCCACCCATGGCAAATTCCATGGCACCGTCAAGGCTGAGAACGGGAAGCTTGTCATCAATGGAAATCCCATCACGATCTTCCAGGAGCGAGATCCGTC	Seq Percent=150%

GGCATTCCTGAAGCTGACAGCATTCGGGCCGAGATGTCTCGCTCCGTGGCCTTAGCTGTGCTCGCGCTACTCTCTCTTTCTGGCCTGGAGGCTATCCAGCGTACTCCAAAGATTCAGGTTTACTCACGTCATCCAGCAGAGAATGGA	Seq Percent=147%

TCAAAATCAAGTGGGGCGATGCTGGCGCTGAGTACGTCGTGGAGTCCACTGGCGTCTTCACCACCATGGAGAAGGCTGGGGCTCATTTGCAGGGGGGAGCCAAAAGGGTCATCATCTCTGCCCCCTCTTCTGACGCCCCCATGTTCGTCAT	Seq Percent=151%

NTGGCCTGGAGGCTATCCAGCGTACTCCAAAGATTCAGGTTCACTCACGTCATCCAGCAGAGAATGGA	Seq Percent=68%

TTTTGGCTTGGAGGCTATCCAGCGTACTCCAAAGATTCAGGTTTACTCACGTCATCCAGCAGAGAATGGA	Seq Percent=70%

CTGATTCAGGTTTACTCACGTCATCCNNNAGAGAATGGA	Seq Percent=39%

GGGCATACCTGAAGCTGACAGCATTCNNNCCGAGATGTCTCGCTCCGTGGCCTTAGCTGTGCTCGCGCTACTCTCTCTTTCTGGCCTGGAGGCTATCCAGCGTACTCCAAAGATTCAGGTTTACTCACGTCATCCAGCAGAGAATGGA	Seq Percent=148%

GGCATACCTGAAGCTTACAGCATTCGGGCCGAGATGTCTCGCTCCGTGGCCTTAGCTGTGCTCGCGCTACTCTCTCTTTCTGGCCTGGAGGCTATCCAGCGTACTCCAAAGATTCAGGTTTACTCACGTCATCCAGCAGAGAATGGA	Seq Percent=147%

ACACTCTCAATCTGGCCTGGAGGCTAAAAATCGTACTCCAAAGATTCAGGTTTACTCACGTCATCCAGCAGAGAATGGA	Seq Percent=79%

CACAAAAACTAGATCGGAAAATCCCCCTTCTGAACTCCAGTCACGTGTTTATCTCGTATGCCGTCTTCTGCTTGAAAAAAAAAAAAAAAAAAAAAAATAAAACCAAAAGATGAACAATAAAGAGAAGGACAAAAAAGATAGAACAGAA	Seq Percent=148%

GGGGCATTCCTGAAGCTGACAGCATTCGGGCCGAGATGTCTCGCTCCGTGGCCTTAGCTGTGCTCGCGCTACTCTCTCTTTCTGGCCTGGAGGCTATCCAACGTACTCCAAAGATTCAGGTTTACTCACGTCATCCAGCAGAGAATGGAAG	Seq Percent=151%

TTTTGGCCTGGAGGCTATCCAGCGTANNNCAAAGATTCAGGTTTACTCACGTCATCCAGCAGAGAATGGA	Seq Percent=70%

TTGGGTTGCGGCCTCAACGAGCACAANNNCCACCTCATCAACGACTTCACCGTCAAGCAGATTAGACAGGGGGCCTTCCTGGTGAACACAGCCCT	Seq Percent=95%

AGCTACTACAAAGATTCAGGTTTCCTCACGTCATAAAGAAGAGAATGGAAGATCGGAAGAGCATACGTCTGAACTACAGAAACGTGGTTATAACGTAGGCAGAAAGATGAAGGAACAAAAAAAAAAACACAACAAATACAACAACAAATAA	Seq Percent=151%

GATGCTGACAGCATTCGGGCCGAGATGTCTCGCTCCGTGGCCTTAGCTGTGCTCGCGCTACTCTCTCTTTCTGGCCTGGAGGCTATCCAGCGTACTCCAAAGATTCAGGTTTACTCACGTCATCCAGCAGAGAATGGA	Seq Percent=138%

CGGCTGGTGGAAATATTTATGTGTTAAAGGTTCTTGCCTGCCACTCTTAGGAAATTTGGTGTACAGAGAGTCATCCTGTCACTGTTGAAATGTTTAACACACCATAGAAACCTTATTCCTTGTTTCCATATAACACTAGTTTTCAATTTAA	Seq Percent=151%

ACCTTTCTTGCCTTGAGGCTATCCAGCGTACTCCAAAGATTCAGGTTTACTCACGTCATCCAGCAGAGAATGGA	Seq Percent=74%

GGGGAAATAATGAATAAGACAGCATTCGGGCAGCTATGTCTCTCACATTTGCCTTAGCTAAGCTAGCGCTACTAGCTCCTTCTGGCCTTGAGGCTATCCATCGTACTCCAAATATTCATGTTTACTCACGTCATCCAGCAGATAATGGAAT	Seq Percent=151%

CCGTGGCCTTATCTGTGCTCGCTCTACTCTCTCTTTCTGGCCTGGAGGCTATCCAGCGTACTCCAAAGATTCAGGTTTACTCACGTCATCCAGCAGAGAATGGA	Seq Percent=104%

AATGACAGCGTTCGGGCCGAGATGTCTAGATCCGAGGCCATAGAAGTGAGAGCGCTACAAGAGCTTTCTGGCCTGAAAGAAATCCAAAATACTCAAAATATTCAGTTTTACTCAAGTCATCCAGCCGATAATTGAAGATCTTAATAGCACA	Seq Percent=151%

TAACTCCAAAGATTCAGGTTTACTCACGTCATCCAGCAGAGAATGGA	Seq Percent=47%

GNACGTGCCAGAGGCTGTTCACCTTGGAGACCTGCTGCGGAAATGGGTACGGCCCGGCGCGAGATTTACACCCTCTCCCCCGGATTTTCAAGGGCCAGCGAGAGCTCACCGGACGACGCAGGAACCGCGACGCTTTCCAAGGCACGGGCC	Seq Percent=150%

TTCTGGCCTGGAGGCTATCCAGCGTACTCCAAAGATTCANNNTTACNNACGTCATCCAGCAGAGAATGGA	Seq Percent=70%

CTTTCTGGCCTGGAGGCTATCCAGCGTACTCCAAAGATTCAGGTTTACTCACGTCATCCAGCAGAGAATGGA	Seq Percent=72%

GCGTACCCCAAAGATTCAGGTTTACTCACGTCATCCAGCAGAGAATGGA	Seq Percent=49%

GTTGGCCCTAGCTGTGCTCGCGCTACTCTCTCTTTCTGGCCTGGAGGCTATCCAGCGTACTCCAAAGATTCAGGTTTACTCACGTCATCCAGCAGAGAATGGA	Seq Percent=103%

CCTTCTTTCCTTTCGGCTCTCCCGCGTCCTCCAAAGATCCCTGTTTCCTCACGTCCTCCAGCAGCGAATGGAAGCTCGGACGCGCACACGTCTGAACACCAGTCACGTGTATATATCGACTGCCGTCCTACGCTATCCAAAAAAAACCCCA	Seq Percent=151%

AAATGCATAACCATCTTCCAGGAGCGAGATCCCTCCAAAATCAAGTGGGGCGATGCTGGCGCTGAGTACGTCGTGGAGTCCACTGGCGTCTTCACCACAATGGAGAAGGCTGGGAATCATTTGCAGGGGGGAGCCAAAAGGGTCATCAT	Seq Percent=149%

GTAGCGCTGCGGGCCAAGGCCTTCGGNNNCAACGTGCGCTTCTACGACCCTTACTTGTCGGATGGCGTGGAGCGGGCGCTGGGGCTGAAGCGTGTCAGCACACTGCAGGACCTGCTCTTCCACAGCGACTGCGTGACCCTGCACTGCGGC	Seq Percent=150%

GCGACTGTGTGACCCTGCACTGCGGCCTCAACGAGCACAACCACCACCTCATCAGCGACTTCACCGTCAAGCAGATGAGACAAGGGGCCTTCCTGGTGAACACAGCCCG	Seq Percent=109%

GGGCAATCCTGCAGCTGACAGCATTCGGGCCGAGATGTCTCGCTCCGTGGCCTTAGCTGTGATCGCGCTACTCTATCTTTCTGGCCTGGAGGCTATCCAGCGTACTACAAAGATTCAGGTTTACTCACGTCATCCAGAAGAGAATGGA	Seq Percent=148%

GGGCAATCCTGAAGCTGACAGCATTCGGGCCGAGATGTCTCGATCCGTGGCCTTAGCTGTGCTCGCGCTACTCTCTCTTTCTGGCCTGGAGGCTATCCAGCGTACTCCAAAGATTCAGGTTTACTCACGTCATCCAGCAGAGAATGGA	Seq Percent=148%

GATTCCTGAAGCTGACAGCATTCGGGCCGAGATGTCTCGCTCCGTGGCCTTAGCTGTGCTCGCGCTACTCTCTCTTTCTGGCCTGGAGGCTATCCAGCGTACTCCAAAGATTCAGGTTTACTCACGTCATCCAGCAGAGAATGGA	Seq Percent=145%

ATGGCTNCACTCACATCCTTCCTCCTGTACTTACCCCAGCNCAGGTNNCCCCTGCTTTGTGACCATGATGTCCTGTACCCTGCCCTGCGCCCTGTGCTCCTGGCACTGTCTNTGCTGCCCNGGGTCTGTCACTCCGNTCCCCTTGGGCNC	Seq Percent=150%

CTTCTGACCTGGAGGCTATCCAGCGTACTCCAAAGATTCAGGTTTACTCACGTCATCCAGCAGAGAATGGA	Seq Percent=71%

CTTCTGGCCTGGAGGCTATCCAGCGTACTCCAAAGATTCAGGTTTACTCACGTCATCCAGCAGAGAATGGA	Seq Percent=71%

GAGAACGGGAAGCTTGTCATCAATGGAAATCCCATCACCATCTTCCAGGAGCGAGATCCCTCCAAAATCAAGTGGGGCGATGCTGGCGCTGAGTACGTCGTGGAGTCTACTGGCGTCTTCACCACCATGGAGAAGTCTGGGGCTCATTTG	Seq Percent=150%

GAGAACGGGAAGCTTGTCATCAATGGAAATCCCATCACCATCTTCCAGGAGCGAGATCCCTCCAAAATCAAGTGGGGCGATGCTGGCGCTGAGTACGTCGTGGAGTCTACTGGCGTCTTCACAACCATGGAGAAGGCTGGGGCTCATTTG	Seq Percent=150%

ACATGGTTTACNTGTTCCAATATGATTCCACCCATGGCAAATTCCATTGCACCGTCAAGGCTGAGAACGGGAAGCTTGTCATCAATGGAAATCCCATCACCATCTTCCAGGAGCGAGATCCCTCCAAAATCAAGTGGGGCGATGCTGGCG	Seq Percent=150%

TCGCGCTTCTCTCTCTTTCTGGCCTGGAGGCTATCCAGCNTACTCCNAAGATTCAGGTTTACTCACGTCATCCAGCAGAGAATGGAAGATCGGAAGAGCNCACGTCTGAACNCNAGTCANNTGTTTATCTCGTATNNCGTCTTCTGCNNGA	Seq Percent=151%

TCGCGCTTCTCTCTCTTTCTGGCCTGGAGGCTATCCAGCGTACTCCNAAGATTCAGGTTTACTCACGTCATCCAGCAGAGAATGGA	Seq Percent=86%

CTTTTAGCCTGNAGGCTATCCAGCGTACTCCAAAGATTCAGGTTTACTCACGTCATCCAGCAGAGAATGGA	Seq Percent=71%

GCTACTCCAAAGATTCAGGTTTACTCACGTCATCCAGCAGAGAA	Seq Percent=44%

CTTTTGGCCTGGAGGCTATCCAGCGTACTCCGAAGATTCAGGTTTACTCACGTCATCCAGCAGAGAATGGA	Seq Percent=71%

CTGCCCCCTCTGCTGACGCCCCCATGNNNGTCATGGGTGTGAACCA	Seq Percent=46%

GGCCTGGGGGCTATCCAGCGTACTCCAAAGATTCAGGTTTACTCACGTCATCCAGCAGAGAATGGA	Seq Percent=66%

GATTGATCCTGCCATTAGCATATGCTTGTCTCAAAGATTAAGCCATGCATGTCTAAGTACGCACGGCCGGTACAGTGAAACTGCGAATGGCTCATTAAATCAGTTATGGTTCCTTTNGTCGCTCGCTCCTCCCNTACCTGNNTNACTGTGN	Seq Percent=151%

GGGCATTCCTGAAGCTGACAGCATTCGGGCCGAGATGTCTCGCTCCGTGGCCTTAGCTGTGCTCGCGCTACTCTCTCTTTCTGGCCTGGAGGCTATCCAGCGTACTCCAAAGATTCAGGTTTACTCATGTCATCCAGCAGAGAATGGAGGA	Seq Percent=151%

GAAAAGCAGTGGACATCTTAGGAGTTGGAAGTGGAGAAATCAAAGTAGCAGTGAAGACTTTGAAGAAGGGTTCCACAGACCAGGAGAAGATTGAATTCCTG	Seq Percent=101%

GAAAAGCAGTGGACATCTTAGGAGTTGGAAGTGGAGAAATCAAAGTAGCAGTGAAGACTTTGAAGAAGGGTTCCACAGACCAGGAGAAGATTGAATTCCTG	Seq Percent=101%

GACAGTCCGCCGCATCTTCTTTTGCGNNNCCAGCCGAGCCACATCGCTGAGGCACCATGGGGAAGGTGAAGGTCGGAGTCAACGGATTTGGTCGTATTGGGCGCCTGGTCACCAGGGCTGCTTTTAACTCTGGTAAAGTGGATATTGTTG	Seq Percent=150%

GGCCTGGAGGCTATCCAGCGTACTCCAAAGATTCAGGTTTACTCACGTCATCCAGCAGAGAATGGA	Seq Percent=66%

AGAAGGCAAGGAGGGAAGAGAGAGAAAAAAAACGATTCANGTTTACNNACGTCATCCAGCAGAGAATGGA	Seq Percent=70%

AAAGGGCAAGGAGGAAAGAGAGAGAAAAAAAACGATTCNNNNTTACNNACGTCATCCAGCAGAGNATGGAAGATCGGAAGNNNACACGTCTGAACTCCNNTCACGTGTTTANANCGTATNNCGTCTTNNGNTTGANNNAAAAAAAANNNNA	Seq Percent=151%

CTGGCCCGGAGGCTATCCAGCGTACTCCAAAGATTCAGGTTTATTCACGTCATCCAGCAGAGAATGGA	Seq Percent=68%

TCAAAGNCCTCCGCATCATCGTCCGGATTGGCAGTGGTTNNNACAANNTCGACATCAAGTCGGCCGGGGATTTANACATTGNNGTCTGCAACGTGCCCNNGGCGTCTGTGGNGNAGACGNNCGACTCANAGCTGTNNAACATCCTGNNN	Seq Percent=149%

GACTGCATTCGGGCCGAGATGTCTCGNNNCGTGGCCTTAGGTGTGCTCGCGCTACTCTCTATTTCTGGCCTGGAGACTATCCAGCGTACTCCAAAGATTAAGGTTTACTCACGTCATCCAGCAGAGAATGGA	Seq Percent=132%

CTTTTCTGTCCNGGAGGCTATCCAGCGTACTCCAAAGATTCAGGTTTACTCACGTCATCCAGCAGAGAATGGA	Seq Percent=73%

CTTTCTGGCCTGGAGGCTATCCAGCGTACTCCAAAGATTCAGGTTTACTCACGTCATCCAGCAGAGAATGGA	Seq Percent=72%

CTTATATGTCGGATGGCGTGGAGCGGGCGCTGGGGCTGCAGCGTGTCAGCACCCTGCAGGACCTGCTCTTCCACAGCGACTGCGTGACCCTGCACTGCGGCCTCAACGAGCACAACCACAACCTCATCAACGACTTCACCGTCAAGC	Seq Percent=147%

GCATTCCTGAAGCTGACAGCATTCGGGCCGAGATGTCTCGCTCCGTGGCCTTAGCTATGCTCGCGCTACTCTCTCTTTCTGGCCTGGAGGCTATCCAGCGTACTCCAAAGATTCAGGTTTACTCACGTCATCCAGCAGAGAATGGA	Seq Percent=146%

CCTACGACCCTTACTTGTCGGATGGCGTGGAGCGGGCGCTGGGGCTGCAGCGTGTCAGCACCCTGCAGGACCTGCTCTTCCACAGCGACTGCGTGACCCTGCACTGCGGCCTCAACGAGCACAACCACCACCTCATCAACGACTTCACCGT	Seq Percent=151%

CGTCAAGGCTGAGAACGGGAAGCTTGTCATCAATGGAAATCCCATCACCATCTTCCAGGAGCGAGATCCCTCCAAAATCAAGTGGGGCGATGCTGGCGCTGAGTACGTCGTGGAGTCCACTGGCGTCTTCACCACCATGGAGAAGGCTGGG	Seq Percent=151%

NTCTGCCCCCTCTGCTGATGCCCCCATNNTCGTCATGGGTGTGAACCA	Seq Percent=48%

GCGCCAAAGATTCAGGTTTACTCACGTCATCCAGCAGAGAATGGA	Seq Percent=45%

GAGGGCCCGAAGACATCCAGGATCCACNNTGCGACGAGCTGTGCCGCACGGTGAT	Seq Percent=55%

GCAATGCGGCCTCAACGAGCACAACCACCACCTCATCAACGACTTCACCGTCAAGCAGATGAGACAAGGGGCCTTCCTGGTGAACACAGCCCG	Seq Percent=93%

GCAATGCGGCCTCAACGAGCACAACCACCACCTCATCAACGACTTCACCGTCAAGCAGATGAGACAAGGGGCCTTCCTGGTGAACACAGCCCG	Seq Percent=93%

GGGGCATTCCTGAAGCTGACAGCATTCGGGCCGAGATGTCTCGCTCCGTGGCNTTAGCTGTGCTCGCGCTACTCTCTCTTTCTGGCCTGGAGGCTATCCAGCGTACTCCAAAGATTCAGGTTTACTCACGTCATCCAGCAGAGAATGGAAG	Seq Percent=151%

TCTGGCTGGAGGCTATCCAGCGTACTCNNAAGATTAAGGTTTACTCACGTCATCCAGCAGAGAATGGA	Seq Percent=68%

TTCAGGTTTACTCACGTCATCCAGCANNNAATGGA	Seq Percent=35%

GGGGCATCCCTGAAGCCGACAGCATTCGGGCCGAGATGTCTCGCTCCGTGGCCTTAGCTGTGCTCGCGCTACTCTCTCTTTCTGGCCTGGAGGCTATCCAGCGTACTCCAAAGATTCAGGTTTACTCACGTCATCCAGCAGAGAATGGAAG	Seq Percent=151%

GGGGCATCCCTGAAGCCGACAGCATTCGGGCCGAGATGTCTCGCTCCGTGGCCTTAGCTGTGCTCGCGCTACTCTCTCTTTCTGGCCTGGAGGCTATCCAGCGTACTCCAAAGATTCAGGTTTACTCACGTCATCCAGCAGAGAATGGAAG	Seq Percent=151%

TTCTGGCCTGGAGGCTATCCAGCGTACTCCAAAGATTCAGGTTTACTCACGTCATCCAGCAGAGAATGGA	Seq Percent=70%

TGCGTGGCCTTAGCTGTGCTCGCGCTACTCTCTCTTTCTGGCCTGGAGGCTATCCAGCGTACTCCAAAGATTCAGGTTTACTCACGTCATCCAGCAGAGAATGGA	Seq Percent=105%

CCCTGCCTGCGGCCTCAACGAGCACAACCACCACCTCATCAACGACTTCACCGTCAAGCATATGAGACAAGGGGCCTTCCTGGTGAACACAGCCCG	Seq Percent=96%

AAAAGTAAAGGGGAGAAGCGGAAGAGNNNAAAGACGTGGAAAAAAGTGGAGTATTAACCACAATAGGAAAGGATGGGGAACATTTGAAGGGGGGAGCCAAGAGGAGAATCATCTAAGAAACCAATGAAAAGGCCAACATGTAAGACATGGG	Seq Percent=151%

GGGGCATTCCTGAAGCTGACAGCATTNNNGCCGAGATGTCTCGCTCCGTGGCCTTAGCTGTGCTCGCGCTACTCTCTCTTTCTGGCCTGGAGGCTATCCAGCGTACTCCAAAGATTCAGGTTTACTCACGTCATCCAGCAGAGAATGGAAG	Seq Percent=151%

GGGGCATTCCTGAAGCTGACAGCATTCNGGCCGAGATGTCTCGCTCGGTGGCCTTAGCTGTGCTCGCGCTACTCTCTCTTTCTGGCCTGGAGGCTATCCAGCGTACTCCAAAGATTCAGGTTTACTCACGTCATCCAGCAGAGAATGGAAG	Seq Percent=151%

CAGGCTGAGGATCATTTGCAGGGGGGANCCAAAAGGGTCATCATCTCTGCCCCCTCTGCTGACGCCCCCATGTTCGTCATGGGTGTGAACCA	Seq Percent=92%

CTTGGTCGGATGGCGTGGAGCGGGCGCTGGGGCTGCAGCGTTTCAGCACCCTGCAGGACCTGCTCTTCCACAGCGACTGCGTGACCCTGCACTGCGGCCTCAACGAGCACAACCACCACCTCATCAACGACTTCACCGTCAAGCAGATGAG	Seq Percent=151%

CCGATTGTGAACGGGCCCCTGCACCCGCGGCCCCTGGTGGCATTGCTGGATGGCCGGGACTGCACAGTGGAGATGCCCATCCTGAAGGACGTGGCCACTGTGGCCTTCTGCGACGCGCAGTCCACGCAGGAGATCCATGAGAAGGTCCTGA	Seq Percent=151%

TTCTGGGTTGGAGGCTATCCAGCGTACTCCAAAGATTCATGTTTACTCACGTCATCCAGCAGAGAATGGA	Seq Percent=70%

GGGTATTCCTGAAGCTGACAGCATTCNNNCCGAGATGTCTCTCTCCGTGGCCTTAGCTGTGCTCGCGCTACTCTCTCTTTCTGGCCTGGAGGCTATCCAGCGTACTCCAAAGATTCAGGTTTACTCACGTCATCCAGCAGAGAATGGA	Seq Percent=148%

GGCTGCACCAGGCGCTGCGGGAGGGCNNNCGAGTCCAGAGCGTCGAGCAGATCCGCGAGGTGGCGTCCGGCGCTGCCAGGATCCGCGGGGAGACCTTGGGCATCATCGGACTTGGTCGCGTGGGGCAGGCAGTGGCGCTGCGGGCCAAGG	Seq Percent=150%

CCGCTGATGCCCCCATGTTCGTCATGGGTGTGAACCA	Seq Percent=37%

GCACCATCTTCCAGGAGCGAGATCCCTCCAAAATCAAGTGGGGCGATGCTGGCGCTGAGTACGTCGTGGAGTCCACTGGCNNCTTCACCACCATGGAGNNGGCTGGGGCTNNTNTGCANNNGGGAGCNNANAGGGNNNTCATCTCTNNNN	Seq Percent=150%

GTTTTGGCCTGGAGGCTATCCAGCGTACTCCAAAGATTCAGGTTTACTCACGTCATCCAGCAGAGAATGGA	Seq Percent=71%

CTTTCTGGCCTGGAGGCTATCCAGCGTNNTCCAAAGATTCAGGTTTACTCACGTCATCCAGCAGAGAATGGA	Seq Percent=72%

GCAGACCCTGCACTGCGGCCTCAACGANCACAACCACCACCTCATCAACGACTTCACCGTCAAGCAGATGAGACAAGGGGCCTTCCTGGTGAACACAGCCCG	Seq Percent=102%

TTAGGCTGAGAACGGGAAGCTTGTCATCAATGGAAATCCCATCACCATCTTCCAGGAGCGAGATCCCTCCAAAATCAAGTGGGGCGATGCTGGCGCTGNNAACGTCGTGGANTNCACTNNNGTCTTCACCACCATNNAGAAGGCTGGNN	Seq Percent=149%

TTTTGGCCCGGAGGCTATCCAGCGTACTCCAAAGATTCAGGTTTACTCACGTCATCCAGCAGAGAATGGA	Seq Percent=70%

CTTCTGGCCTGGAGGCTATCCGGCGTACTCCAAAGATTCAGGTTTACTCACGTCATCCAGCAGAGAATGGA	Seq Percent=71%

CCGTAGCCAAANGCCTCGTCATCTAATTAGTGACGCGCATGAATGGATGAACGAGATTCCCACTGTCCCTACCTACTATCCAGCGAAACCACAGCCAAGGGAACGGGCTTGGCGGAATCAGCGGGAAAAGAAGACCCTGTTGAGCTTGA	Seq Percent=149%

GGTTCCTGAAGCTGACAGCATTCGGGCCGAGATGTCTCGCTCCGTGGCCTTAGCTGTGCTCGCGCTACTCTCTCTTTCTGGCCTGGAGGCTATCCAGCGTACTCCAAAGATTCAGGTTTACTCACGTCATCCAGCAGAGAATGGA	Seq Percent=145%

GATGCTGACAGCATTCGGGCCGAGATNNNNCGCTCCGTGGCCTTAGCTGTGCTCGCGCTACTCTCTCTTTCTGGCCTGGAGGCTATCCAGCGTACTCCAAAGATTCAGGTTTACTCACGTCATCCAGCAGAGAATGGA	Seq Percent=138%

TAGTTTGTCGGATGGCGTGGAGCGGGCGCTGGGGCTGCAGCGGGTCAGCACCCTGCAGGACCTGCTCTTCCACAGCGACTGCGTGACCCTGCACTACGGCCTCAACGAGCANAACCACCANCTCATCAACGACTTCNCCGTCAAGCAANAA	Seq Percent=151%

TAGTTTGTCGGATGGCGTGGAGCGGGCGCTGGGGCTGCAGCGTGTCAGCACCCTGCAGGACCTGCTCTTCCACAGCGACTGCGTGACCCTGCACTGCGNNCTCAACGAGCANANCCACNNNCTCATCAACGACTTNNCCGTCAAGCANNTG	Seq Percent=151%

GGCCTAGAGGCTATCCAGCGTACTCCAAAGATTCAGGTTTACTCACGTCATCCAGCAGAGAATGGA	Seq Percent=66%

TGGTCATCTTAGGAGTTGGAAGTGGAGAAATCAAAGTAGCAGTGAAGACTTTGAAGAAGGGTTCCACAGACCAGGAGAAGATTGAATTCCTG	Seq Percent=92%

CGCCCGCTCTGCTGACGCCCCCATGTTCATCATGGGTGTGAACCA	Seq Percent=45%

TTCTGGCCTGGAGGCTATCCAGCGTACTCCAAAGATTCAGGTTTACTCACGTCATCCAGCAGAGAATGGA	Seq Percent=70%

GTCTAGGCCTGGAGGCTATCCAGCGTACTCCAAAGATTCAGGTTTACTCACGTCATCCAGCAGAGAATGGA	Seq Percent=71%

GTCCGGCTCCANTAGCGTATATTAAAGTTGCTGCAGTTAAAAAGCTCGTAGTTGGATCTCGGGGACGGGCGGTGGCTCGCCTCGCGGCGGACCGCCCGTCCCCGCCCCTTGCCTCTCGGCGCCCCCTCGATGCTCTTAGCTGAGTGTCCCG	Seq Percent=151%

CTCATCATCTCTGCCCCCTCTGCTGANNNCCCCATGTTCGTCATGGGTGTGAACCA	Seq Percent=56%

GGGGCATTGCTGAAGCTGACCGCATTCGGGCCGAGATGTCTCGCTCCGTGGCCTTAGCTGTGCTCGCGCTACTCTCTCTTTCTGGCCTGGAGGCTATCCAGCGTACTCCAAAGATTCAGGTTTACTCACGTCATCCAGCAGAGAATGGAAA	Seq Percent=151%

GNGCATTCCTGAAGCTGACAGCATTCGGGCCGAGATGTCTCGCTCCGTGGCCTTAGCTGTGCTCGCGCTACTCTCTCTTTCTGGCCTGGAGGCTATCCAGCGTACTCCAAAGATTCAGGTTTACTCACGTCATCCAGCAGAGAATGGA	Seq Percent=148%

GGGGCATTCCTGAAGCTGACAGCATTCNGGCCGAGATGTCTCGCTCCGTGGCCTTAGCTGTGCTCGCGCTACTCTCTCTTTCTGGCCTGGAGGCTATCCAGCGTACTCCAAAGATTCAGGTTTACTCACGTCATCCAGCAGAGAATGGAAG	Seq Percent=151%

CGAATTTAAATGGGAAAGAAGCCCGGCTCGCTGGCGTGGGGCCGGGCTTCTTACCCATTTAAAGTTTGAGAATAGGTTGAGATCGTTTCGGCCCCAAGACCTCTAATCACTCGCTTTANNAGATAAAAAAGCGAGGAGATCGGAAGAANA	Seq Percent=150%

GGGGCATTCCTGAAGCTGACAGCATTNNNGCCGAGATGTCTCGCTCCGTGGCCTTAGCTGTGCTCGCGCTACTCTCTCTTTCTGGCCTGGAGGCTATCCAGCGTACTCCAAAGATTCAGGTTTACTCACGTCATCCAGCAGAGAATGGAAG	Seq Percent=151%

GGGGCATTCCTGAAGCTGACAGCATTNNNGCCGAGATGTCTCGCTCCGTGGCCTTAGCTGTGCTCGCGCTACTCTCTCTTTCTGGCCTGGAGGCTATCCAGCGTACTCCAAAGATTCAGGTTTACTCACGTCATCCAGCAGAGAATGGAAG	Seq Percent=151%

ATTTCTGGAATGGAGGCTATACAGCGNNNTCCAAAGATTCAGGTTTACTCACGTCATCCAGCAGAGAATGGA	Seq Percent=72%

GGTTTTCTAACGTCATCCAGAAGAGAATGGA	Seq Percent=31%

TGGCAGTGGTTTTGACAACATCGACATCAAGTCGGCCGGGGATTTAGGCATTGCCGTCTGCAACGTGCCCGCGGCGTCTGTGGAGGAGACGGCCGACTCGACGCTGTGCCACATCCTGAACCTGTACCGGCGGNNCACCTGGCTGCACCAG	Seq Percent=151%

TGGCAGTGGTTTTGACAACATCGACATCAAGTCGGCCGGGGATTTAGGCATTGCCGTCTGCAACGTGCCCGCGGCGTCTGTGGAGGAGACGGCCGACTCGACGCTGTGCCACATCCTGAACCTGTACCGGCGNGNCACCTNGCTGCACCAN	Seq Percent=151%

GGGGCATTCCTGAAGCTGACAGCATTCGGGCCGAGATGTCTCGCTCCGTGGCCTTAGCTGTGCTCGCGCTACTCTCTCTTTCTGGCCTGGAGGCTATCCAGCGTACTCCAAAGATTCAGGTTTACTCACGTCATCCAGCAGAGAATGGAAA	Seq Percent=151%

GCTATTTCTGGCCTGGAGGCTATCCAGCGTACTCCAAAGATTCAGGTTTACTCACGTCATCCAGCAGAGAATGGA	Seq Percent=75%

TTCTTGACGGAGGCTATCCAGCGTACTCCAAAGATTCAGGTTTACTCACGACATCCAGCAGAGAATGGA	Seq Percent=69%

GGGCTGGCGGCTATCCAGCGTACTCCGAAGATTCAGGTTTACTCACGTCATCCAGCAGAGAATGGA	Seq Percent=66%

CNTAACTTTAAATGGGTAAGAAGCCCGGCTCGCTGGCGTGGAGCCGGGCGAGGAATGCGAGTGCCTAGTGGGCCAATTTTGGTGGATGAGAAGGCGC	Seq Percent=97%

TCGGCTGGCGACGCAAAAGAAGATGCGGCTGACTGTCGAACAGGAGGAGCAGAGAGCCCATGGGGAAGGTGAAGGTCGGAGTCAACGGATTTGGTCGTATTGGGCGCCTGGTCACCAGGGCTGCTTTTGACTCTGGTAAAGTGGATATTGT	Seq Percent=151%

TCGGCTGGCGACGCAAAAGAAGATGCGGCTGACTGTCGAACAGGAGGAGCAGAGAGCCCATGGGGAAGGTGAAGGTCGGAGTCAACGGATTTGGTCGTATTGGGCGCCTGGCCACCAGGGCTGCTTTTGACTCTGGTAAAGTGGATATTGT	Seq Percent=151%

TCTGGCTGGAGGCTATCCAGCGTACTCNNAAGATTCAGGTTTACTCACGTCATCCAGCAGAGAATGGA	Seq Percent=68%

TTGTTGGCCTGGGGGCTATCCAGCGTACTCCAAAGATTCAGGTTTACTCACGTCATCCAGCAGAGAATGGA	Seq Percent=71%

TCTCTTTCTGGCCTGGAGGCTATCCAGCGTACTCCAAAGNTTCAGGNTTACTCACGTCATCCAGCAGAGAATGGA	Seq Percent=75%

TTCAGGCCTGGAGGCTATCCAGCGTACTCCAAAGATTCAGGTTTACTCACGTCATCCAGCAGAGAATGGA	Seq Percent=70%

TAATTGTCGGATGGCGTGGAGCGGGCGCTGGGGCTGCAGCGTGTCAGCACCCTGCAGGACCTGCTCTTCCACAGCGACTGCGTGACCCTGCACTGCGGCCTCAACGAGCACAACCACCACCTCATCAACGACTTCACCGTCAAGCAGATGA	Seq Percent=151%

TTCTGGCCTGGAGGCTATCCNGCGTANNNCAAAGATTCAGGTTTACTCACGTCATCCAGCAGAGAATGGA	Seq Percent=70%

GGTCTGAGGCTATCCAGCGTACTCCAAAGATTCAGGTTTACTCACGNCATCCAGCAGAGAATGGA	Seq Percent=65%

TTCTGGCCTGGAGGCTATCCAGCGTACTCCAAAGATTCAGGTTTACTCACGTCATCCAGCAGAGAATGGA	Seq Percent=70%

CAAACTCAAAATGGGTAAGAAGCCCGGCTCGCTGGCGTGGAGCCGGGCGTGGAGTGCGAGTGCCTAGTGGGCCACTTTTGGTAAGCAGAACTGGCGCTGCGGGATGAACCGAACGCCGGGTTAAGGCGCCCGATGCCGACGCTCATC	Seq Percent=147%

GGGGCATTCCTGAAGCTGACAGCATTCGGGCCGAGATGTNTCGCTCNGTGGCCTTAGCTGTGCTCGCGCCACTCTCTCTTTCTGGCCTGGAGGCTATCCAGCGTACTCCAANGATTCAGGNTTACTCACGTCATCNNGCAGAGAATGGNAG	Seq Percent=151%

CTTTTCGGCCTGGAGGCTATCCAGCGTACTCCAAAGATTCAGGTTTACTCACGTCATCCAGCAGAGAATGGA	Seq Percent=72%

CTTGCTNGGAAGTGGAGCCTTTGGAGAAGTGTATGAAGGNNCAGCANNGGACATCTTAGGAGTTGGAAGTGGAGNAATCAANGTAGCAGTGAAGACTTNNAAGAAGGGTTCNANAGACNNNGAGAAGATTGAATTNNTGAGATCGGANNAG	Seq Percent=151%

CCAGGTTTACTCACGTCATCCAGCAGAGAATGGA	Seq Percent=34%

ATTTAGCTGTGCTCGCGCTACTCTCTCTTTCTGGCCTGGAGGCTATCCAGCGTACTCCAAAGACTCAGGTTTACTCACGTCATCCAGCAGAGAATGGA	Seq Percent=98%

CCGTGGNCTTAGCTGTGCTCGCGCTACTCTCTCTTTCTGGNCTGGANGCTATCCAGCGTACTCCAAAGATTCAGGTTTACTCACGTCATCCAGCAGAGAATGGA	Seq Percent=104%

TTCTGGCCTGGAGGCTATCCAGCGTACTCCAAAGATTCAGGTTTACTCACGTCATCCAGCAGAGAATGGA	Seq Percent=70%

TGGCATCAATGGAAATCCCATCACCATNNTCCAGGAGCGAGATCCCTCCAAAATCAAGTGGGGCGATGCTGGCGCTGAGTACGTCGTGGAGTCCACTGGCGTCTTCACCACCATGGAGAAGGCTGGGGCTCATTTGCAGGGGGGAGCCAAA	Seq Percent=151%

TAGCTGTTCTCGCGCTACTCTCTCTTTCTGGCCTGGAGGCTATCCAGCGTACTCCAAAGATTCAGGTTTACTCACGTCATCCAGCGGAGAATGGA	Seq Percent=95%

GGCTGCCGCAGCTAGGAATAATGGAATAGGACCGCGGTTCTATTTTGTTGGTTTTCGGAACTGAGGCCATGATTAAGAGAGACGGCTGGAGTGTGAGGAAGGGAGAGAGTCGAGATCC	Seq Percent=118%

CTAGGCAAGCCCAGGCCCAGCTGCTTGTAACAGTGGAGGGGTCATATGTGGCCGAGGAGGCGGGCTGCCCCCTGTCCTGTGCAGTCAGCAAAG	Seq Percent=93%

TACCTGGCCTGGAGGCTATCCAGCGTACTCCAAAGATTCAGGTTTACTCACGTCATCCAGCAGAGAATGGA	Seq Percent=71%

GGGTCTGCTTTTAACTCTGGTAAAGTGGATATTGTTGCCATCAATGAACCCTTCAGTGACCTAAACTACATTGTTTACATGTTCCAATATGATTCCACCCATGGCAAATTCCATGGCACCGTAAAGGCTGAGAACGGGAAGCTTGTCATCA	Seq Percent=151%

TTTTGCCTGGAGGCTATCCAGCGTACTCCAAAGCTACATGTCACCTCACTTGATCCAGCCTCGAATGAACGATCGTCAACGAAGAATTATGAACTCCAGTAACTTGATAAGAAGGGATAAAGAAGAGGGAAGGAAAAAAAAAAAGGAGGAA	Seq Percent=151%

TTTGGCCTGGAGGCTATCCAGCGTACTCCAAAGCTTCATTATACCTCCCTTCCTCCAGCCTCTAATGCACTATCGTCAGCGCACACTTCTGAACTCCAGTCACTTGTTGATAGCGTAAGACGTATTATGCATGAAAAAAAAAAAAAAAAAA	Seq Percent=151%

ATCAAGTGGGGCGATGCTGGCGCTGAGTACGTCGTGGAGTCCACTGGCGTCTTCACCACCATGGAGAAGGCTGGGGCTCATTTGCAGGGGGGAGCCAAAAGGGTCATCATCTCTGCCCCCTCTGCTGACGCCCCCATGTTCGTCATGGGTG	Seq Percent=151%

CTTTTTGGCCTGGAGGCTATCCAGCGTACTCCAAAGATTCAGGTTTACTCACGTCATCCAGCAGAGAATGGA	Seq Percent=72%

TGGGCATTCCTGAAGCTGACAGCATTCGGGCCGAGATGTCTCGCTCCGTGGCCTTAGCTGTGCTCGCGCTACTCTCTCTTTCTGGCCTGGAGGCTATCCAGCGTACTCCAAAGATTCAGGTTTACTCACGTCATCCAGCAGAGAATGGAAG	Seq Percent=151%

GATTCCTGCAGCTGACAGCATTCGGGCCGAGATGTCTCGCTCCGTGGCCTTGGCTGTGCTCGCGCTACTCTCTCTTTCTGGCCTGGAGGCTATCCAGCGTACTCCAAAGATTCAGGTTTACTCACGTCATCCAGCAGAGAATGGA	Seq Percent=145%

CNATATCAAGTGGGGCGATGCTGGCGCTGAGTACGTCGTGGAGTCCACTGGCGTCTTCACCACCATGGAGAAGGCTGGGGCTCATTTGCAGGGGGGAGCCAAAAGGGTCATCATCTCTGACCCCTCTGCTGATGCCCCCATGTTCGTCATG	Seq Percent=151%

TCCACTTGCCGGATGGCGTGGAGCGGGCGCTGGGGCTGCAGCGTGTCAGCACCCTGCAGGGCCTGCTCTTCCACAGCGACTGCGTGACCCTGCACTGCGGCCTCAACGAGCACAACCACCACCTCATCAACGACTTCACCGTCAAGC	Seq Percent=147%

CATTGGGGCGATGCTGGCGCTGAGTACGTCGTGGAGTCCACTGGCGTCTTCACCACCATGGAGAAGGCTGGGGCTCATTTGCAGGGGGGAGCCAAAAAGGGTCATCATCTCTGCCCCCTCTGCTGACGCCCCCANGTTCGTCATGGGTGTG	Seq Percent=151%

CATTGGGGCGATGCTGGCGCTGAGTACGTCGTGGAGTCCACTGGCGTCTTCACCACCATGGAGAAGGCTGGGGCTCATTTGCAGGGGGGAGCCAAAAAGGGTCATCATCTCTGCCCCCTCTGCTGACGCCCCCANGTTCGTCATGGGTNTG	Seq Percent=151%

GGGGCATTCCTGAAGCTGACAGCATTCGGGCCGAGATGTCTCGCTCCGTGGCCTTAGCTGTGCTCGCGCTACTCTCTCTTTCTGGCCTGGAGGCTATCCAGCGTACTCCAAAGATTCAGGTTTACTCACGTCATCCAGCAGAGAATGGAAG	Seq Percent=151%

GCATTCCTGAAGCTGACAGCATTCGGGCCGAGATGTCTCGCTCCGTGGCCTTAGCTGTGCTCGCGCTACTCTCTCTTTCTGGCCTGGAGGCTATCCAGCGTACTCCAAAGATTCAGGTTTACTCACGTCATCCAGCAGAGAATGGA	Seq Percent=146%

TTGGGTTGCGCTACAGAAGTGGAAATACAATGAGTTTTACCATGTTAAAACTTCATGCAGCC	Seq Percent=62%

ACTTGTCTGATGGCGTGGAGCGGGCGCTGGGGCTGCAGCGTGTCAGCACCCTGCAGGACCTGCTCTTCCACAGCGACTGCGTGACCCTGCACTGCGGCCTCAACGAGCACAACCACCACCTCATCAACGACTTCACCGTCAAGCAGATGAG	Seq Percent=151%

GCTTTGGCCTGGAGGCTATCCAGCGTACTCCAAAGATTCAGGTTTACTCACGTCATCCAGCAGAGAATGGA	Seq Percent=71%

GTGTACTCCAAAGATTCAGGTTTACTCACGTCATCCAGCAGGGAATGGA	Seq Percent=49%

AAAAGGGAAGACTAGGAGAAAAAGAAGAAGAGGAGGGAGAACAAAGAGAGGAGAAGAAAAAGAGAAGCAAAAAAAGAAGAAGAGTAAAGATAAAATAGAAAAAACAAAAAAGAAGAAAAAACGAGAAATAGGAAAAGGTAAGAGAAAAGTA	Seq Percent=151%

TCATCTGCAGGGGGGAGCCAAAAGGGTCATCATCTCTGCCCCCTCTGCTGATGCCCCCATGTTCGTCATGGGAGTGAACCA	Seq Percent=81%

GATTCCTGAAGCTGACAGCATTCGGGCCGAGATGTCTCGCTCCGTGGCCTTAGCTGTGCTCGCGCTACTCTCTCTTTCTGGCCTGGAGGCTATCCAGCGTACTCCAAAGATTCAGGTTTACTCACGTCATCCAGNAGAGAATGGA	Seq Percent=145%

GGATTTGGTCGTATTGGGCGCCTGGTCACCAGGGCTGCTTTTAACTCTGGTAAAGTGGATATTGTTGCCATCAATGACCCCTTCATTGACCTCAACTACATGGTTTACATGTTCCAATATGATTCCACCCATAGNAAATTCCATGGCACCG	Seq Percent=151%

TTCCAGGCCTGGAGGCTATCCAGCGTANNCCAAAGATTCAGGTTTACTCACGTCATCCAGCAGAGAATGGA	Seq Percent=71%

CGGTTTGAGGGACAGGGATGTAGGGCAGGGGAGTGGGAAAGTGAGGTTTTTCTAAAGGCTTCAGGTTATTAGAGGTAGTAGGTAAATGTCATGGTAGTAGAGTATCTTGGTAGGTCACATAGTTTTTATTTATCTTGTTTTCTTGTGTAAT	Seq Percent=151%

TGGGCATTCCTGAAGCTGACAGCATTCGGGCCGAGATGTCTCGCTCCGTGGCCTTAGCTGTGCTCGCGCTACTCTCTCTTTCTGGCCTGGAGGCTATCCAGCGTACTCCAAAGATTCAGGTTTACTCACGTCATCCAGCAGAGAATGGAAG	Seq Percent=151%

GATTCCTGAAGCTGACAGCATTCGGGCCGAGATGTCTCGCTCCGTGGCCTTAGCTGTGTTCGCGCTACTCTCTCTTTCTGGCCTGGAGGCTATCCAGCGTACTCCAAAGATTCAGGTTTACTCACGTCATCCAGCAGAGAATGGA	Seq Percent=145%

CAGCCCTCCAGCCGTCTCTTCACCGTGCCAGACTAGAGTCAAGCTCAACAGGGTCTTCTTTCCCCGCTGATTCCGCCAAGCCCGTTCCCTTGGCTGTGGTTTCGCTGGATAGTAGGTAGGGACAGTGGGAATCTCGTTCATCCATTCATG	Seq Percent=150%

CGCTCCGTGGCCTTAGCTGTGCTCGCGCTACTCTCTCTTTCTGGCCTGGAGGCTATCCAGCGTACTCCAAAGATTCAGGTTTACTCACGTCATCCAGCAGAGAATGGA	Seq Percent=108%

AAAAGAGAAAATAGAGAGGAGGAAAAGGAGGAAGAGAAGTGAGAAGGAGAAAGAGAAGGGAAGAAAAGAGTGAAGGAAGGAAGAAGAAAGGTGAAAACATAAAGAAAGAGAAGTGCAGAGAAAAAGAAGAAAAAATTAAAAAAGAGAGCAA	Seq Percent=151%

NTGACTGGCCTGGAGGCTATCCAGCGTACTCCAAAGATTCAGGTTTACTCACGTCATCCAGCAGAGAATGGA	Seq Percent=72%

GGGGCATTACTGAAGCTGACAGCATTCGGGCCGAGATGTCTCGCTCCGTGGCCTTAGCTGTGCTCGCGCTACTCTCTCTTTCTGGCCTGGAGGCTATCCAGCGTACTCCAAAGATTCAGGTTTACTCACGTCATCCAGCAGAGAATGGAAG	Seq Percent=151%

GCTGACAGCATTCGGGCCGAGATGTCTCGCTCCGTGGCCTTAGCTGTGCTCGCGCTACTCTCTCTTTCTGGCCTGGAGGCTATCCAGCGTACTCCAAAGATTCAGGTTTACTCACGTCATCCAGCAGAGAATGGA	Seq Percent=135%

GGGCATTCCTGAAGCTGACAGCATTCGGGCCGAGATGTCTCGCTCCGTGGCCTTAGCTGTGCTCGCGCTACTCTCTCTTTCTGGCCTGGAGGCTATCCAGCGTACTCCAAAGATTCNGGTTTACNNACGTCATNNAGCAGNNANTGGANGA	Seq Percent=151%

ATTCATGGCAAATTCCATAGCACCGTCATGGCTGAGAACGGGAAGCTTGTCATCAATGGAAATCCCATCACCATCTTCCAGGAGAGAGATCCCTCCAAAATCAAGTGGGGCGATGCTGGCGCTGAGTACGTCGTGGAGTCCACTAGCGT	Seq Percent=149%

GATTGCTGAAGCTGACAGCATTCGGGCCGAGATGTCTCGCTCCGTGGCCTTAGCTGTGCTCGCGCTACTCTCTCTTTCTGGCCTGGAGGCTATCCAGCGTACTCCAAAGATTCAGGTTTACTCACGTCATCCAGCAGAGAATGGA	Seq Percent=145%

GGGGCATTCCTGAAGCTGACAGCATTCGGGCCGAGATGTCTCGCTCCGTGGCCTTAGCTGTGCTCGCGCTACTCTCTCTTTCTGGCCTGGAGGCTATCCAGCGTACTCCAAAGATTCAGGTTTACTCACGTCATCCAGCAGAGAATGGAAG	Seq Percent=151%

GGCATTCCTGAAGCTGACAGCATTCGNNNNGAGGTGTCTCGCTCCGTGGCCTTAGCTGTGCTCGCGCTACTCTCTCTTTCTGGCCTGGAGGCTATCCAGCGTACTCCAAAGATTCAGGTTTACTCACGTCATCCAGCAGAGAATGGAAAAT	Seq Percent=151%

GGCTTACGGGAATCCAGTGGTGGTACATGGATCGAGGGTTCCTTTGTGCTGCATTTTTTACTGCCTCTCTCCTGAGTTGTCGGGATAGATTCTGCAGGCTCTTGTGCTAGCCCAAAGGTGCCCAGCCTTGACTCCACTTCCGTGTCTTTGA	Seq Percent=151%

ATACCGCCAGAAGCACCAGGAGCTGCAAGCCATG	Seq Percent=34%

GCATGTTCCAATATGATTCCACCCATGGCAAATTCCATGGCACCGTCAAGGCTGAGAACGGGAAGCTTGTCATCAATGGAAATCCCATCACCATCTTCCAGGAGCGAGATCCCTCCAAAATCAAGTGGGGCGATGCTGGCGCTGAGTACGT	Seq Percent=151%

GTTCAAAATCAAGTGGGGCGATGCTGGCGCTGAGTACGTCGTGGAGTCCACTGGCGTCTTCACCACCATGGAGAAGGCTGGGGCTCATTTGCAGGGGGGAGCCAAAAGGGTCATTATCTCTGCCCCCTCTGCTGACGCCCCCATGTTCGT	Seq Percent=150%

CTCCGCCCCGACGCACCCCCGCCACGCAGTTTTATCCGGTAAAGCGAATGACTAGAGGTCTTGGGGCCGAAACGATCTCAACCTATTCTCAAACTTTAAATGGGTAAGAAGCCCGGCTCGCTGGCGTGGAGCNGNGCGTGGAATGCGAGTN	Seq Percent=151%

TAGTGGGGCGATGCTGGCGCTGAGTACGTCGTGGGGTCCACTGGCGTCTTCACCACCATGGAGAAGGCTGGGGCTCATTTGCAGGGTGGAGCCAAAAGGGTCATCATCTCTGCCCCCTCTGCTGACGCCCCCATGTTCGTCATGGGTGTGA	Seq Percent=151%

TCATTGCACCTCAACTACATGGTTTACATGTTCCAATATGATTCCACCCATGGCAAATTCCATGGCACCGTCAAGGCTGAGAACGGGAAGCTTGTCATCAATGGAAATCCCATCACCATCTTCCAGGAGCGAGATCCCTCCAAAATCAAGT	Seq Percent=151%

CGTCAACGGATTTGGTCGTATTGGGCGNNTGGTCACCAGGGCTGCTTTTAACTCTGGTAAAGTGGATATTGTTGCCATCAATGACCCCTTCATTGACCTCAACTACATGGTTTACATGTTCCAATATGATTCCACCCATGGCAAATTCCAT	Seq Percent=151%

CTTTGTGGCCTGGAGGCTATCCAGCGTNCTCCAAAGATTCAGGTTTACTCACGTCATCCAGCAGAGAATGGA	Seq Percent=72%

GCCCGCGGCGGGTGTTGACGCGATGTGGTTTCTGGCCAGGGCTCTGAATGTCAAAGTGAAGAAATTCAATGAAGCGCGGGGAAACGGCGGGAGTAACTATGAATCTCTTAAGGGAGCCAAATGACTCGTCATCTAATTAGTGAAGCGCATG	Seq Percent=151%

GACCGCGGAGGGTGTTGACGCGATGTGGTTTCTGGCCAGGGCTCTGAATGTCAAAGTGAAGAAATTCAATGAAGCGCGGGGAAACGGGGGGAGTAACTATGAATCTCTTAAGGGAGCCAAATGCCTCGTCATATAATTAGTGAAGCGCATG	Seq Percent=151%

GGGGCATAACTGAAGCTGACAGCATTCGGGCCGAGATGTCTCGCTCCGTGGCCTTAGCTGTGCTCGCGCTACTCTCTATTTATGGACTGGAGGCTATAGAGAGTAATAAAAAGATTCAGGCTTACTAAAGTCCTGGAGCATCGACT	Seq Percent=146%

GGGGGCATTCCTGAAGCTGACAGCATTCGGGCCGAGATGTCTCGCTCCGTGGCCTTAGCTGTGCTCGCGCTACTCTCTCTTNCTGGCCTGGAGGCTATNNAGCGTACTCCAAAGATTCNNNTTTACTNACGTCATNNAGCAGAGAATNNAA	Seq Percent=151%

ACTGGCCTGGAGGCTATCCAGCGTACTCCAAAGATTCAGGTTTACTCACGTCATCCAGCAGAGAATGGA	Seq Percent=69%

TTGGCTGTGCTCGCGCTACTCTCTCTTTCTGGCCTGGAGGCTATCCAGCGTACTCCAAAGATTCAGGTTTACTCACGTCATCCAGCAGAGAATGGA	Seq Percent=96%

TTCTGGCCTGGAGGCTATCCAGCGTACTCCAAAGATTCAGGTTTACTCACGTCATCCAGCAGAGAATGGA	Seq Percent=70%

GGGGCATTCCTGAAGCTGACAGCATTCGGGCCGAGATGTCTCGCTCCGTGGCCTCAGCTGTGCTCGCGCTACTCTCTCTTTCTGGCCTGGAGGCTATCCAGCGTACACCAAAGATTAAGGTTTACTCACGTCATCCAGCAGAGAATGGAAG	Seq Percent=151%

TTCTGGCCTGGAGGCTATCCAGCGTACTCCAAAGATTCAGGTTTACTCACGTCATCCAGCAGAGAATGGA	Seq Percent=70%

GAAGCTGGCAGCATTCGGGCCGAGATGTCTCGCTCCGTGGCCTTAGCTGTGCTCGCGCTACTCTCTCTTTCTGGCCTGGAGGCTATCCAGCGTACTCCAAAGATTCAGGTTTACTCACGTCATCCAGCAGAANANGGAAGATCGGAAGNGA	Seq Percent=151%

GGTTTACTCACGTCATCCAGCAGAGAATGGA	Seq Percent=31%

TTCTGGCCTGGAGGCTATCCAGCGTACTCCAAAGATTCAGGTTTACTCACGTCATCCAGCAGAGAATGGA	Seq Percent=70%

TCAAGGTGCTCTTCTACGACCCTTACTTGTCGGATGGCGTGGAGCGGGCGCTGGGGCTGCAGCGTGTCAGCACCCTGCAGGACCTGCTCTTCCACAGCGACTGCGTGACCCTGCACTGCGGCCTCAACGAGCACAACCACCACCTCATCAA	Seq Percent=151%

TACGGTCTGGAGGCTATCCAGCGTACTCCAAAGATTCAGGTTTACTCACGTCATCCAGCAGAGAATGGA	Seq Percent=69%

GTCTGGCCTGGAGGCTATCCAGCGTACTCCAAAGATTCAGGTTTACTCACGTCATCCAGCAGAGAATGGA	Seq Percent=70%

ATTCGGGCCGAGATGTCTCGCTCCGTGGCCTTAGCTATGCTCGCGCTACTCTCTCTTTCTGGCCTGGAGGCTATCCAGCGTACTCCAAAGATTCAGGTTTACTCACGTCATCCAGCAGAGAATGGA	Seq Percent=126%

GGGGCATTCCTGAAGCTGACAGCATTCGGGCCGAGATGTCTCGCTCCGTGGCCTTAGCTGTGCTCGCGCTACTCTCTCTTTCTGGCCTGGAGGCTATCCAGCGTACTCCAAAGATTCAGGTTTACTCACGTCATCCAGCAGAGAATGGAAG	Seq Percent=151%

TGGGGCATTCCTGAAGCTGACAGCATTCGGGCCGAGATGTCTCGCTCCGTGGCCTTAGCTGTGCTCGCGCTACTCTCTCTTTCTGGCCTGGAGGCTATCCAGCGTACTCCAAAGATTCAGGTTTACTCACGTCATCCAGCAGAGAATGGAA	Seq Percent=151%

TTCCTGACGACACTCTTTCTCTACACGACGTT	Seq Percent=32%

GGCTACTCCAAAGATTCAGGTTTACTCACGTCATCCAGCAGAGAATGGA	Seq Percent=49%

CTCTTTCAGGCCTGGAGGCTATCCAGCGTACTCCAAAGATTCAGGTTTACTCACGTCATCCAGCAGAGAATGGA	Seq Percent=74%

ACAGCCACCACCTCATCAACGACTTCANNGTCAAGCAGATGAGACAAGGGGCCTTCCTGGTGAACACAGCCCG	Seq Percent=73%

TTGCTGGGCTGGAGGCTATCCAGCGTACTCCAAAGATTCAGGTTTACTCACGTCATCCAGCAGAGAATGGA	Seq Percent=71%

AAAAAAGAAAAAAGGAAATGAAGAAAAAAAAAAACAGAAAAAAACAAAAAGAAAAGATAGAAAAGAGAAAAAAAAAAAAAGAAAAGGAGAAAAGAAAAAAGAAAAAAAAGAAGAAAAAAAAAAAAAACAAAAAAAAAAAGAAGAAAAANNG	Seq Percent=151%

GATTCCTGGAGCTGACAGGATTCGGGCCGAGATGTCTCGCACCGTGGCCTTAGCTGTGCTCGCGCTACTATCTCTTTCTGGCCAGGAGGCTAACCAGCATACTACAAAGATTCAAGTTTACTAACGTCATCCAGCAGAGAATGGA	Seq Percent=145%

NCCGGGACAAGGCCTTCGGCTTCAACNNNCTCTTCTACGACCCTTACTTGTCGGATGGCGTGGAGCGGGCGCTGGGGCTGCAGCGTGTCAGCACCCTGCAGGACATGCTCTTCAACAGCGACTGCGTGACCCTGGACTGCGGCCTCAACGA	Seq Percent=151%

AGAAAAAGAGGAGGGAGAGAAAGAAAGAAAAAAGAGGTGAGAGGAGAAGAAGAAGAAAAAGAAAGAAAGAGGAGGGGAAGCAAGAGAGAAAAGAGAAAGAGAGAAGAAGAGTACGATATAGAAATTAAAAAAGAAAAGGAGGACTGATACA	Seq Percent=151%

GGGCATTCCTGAAGCTGACAGCATTCGGGCAGAGATGTCTCGCTCCGTGGCATTAGAAGTGCTCGCGCTACTCTCTCTTTCTGGCCTGGAGGCTATCCAGCGTACTCCAAAGATTCAGGTTTACTCACGTCATNNAGCAGAGAATGGA	Seq Percent=148%

CCAAAATCCAGTAGGGCGATGCTGGCGCTGAGTACGTCGTGGAGTCCACGGGCGTCTTCACCACCATGGAGAAGGCTGGGGCTCATTTGCAGGGGGGAGCCAAAAGGGTCATCATCTCTGCCCCCTCTGCTGATGCCCCCATGTTCGTCAT	Seq Percent=151%

GCTCGCGCTACTCTCTCTTTCTGGCCNNNAGGCTATCCAGCGTACTCCAAAGATTCAGGTTTACTCACGTCATCCAGCAGAGAATGGA	Seq Percent=88%

CTCCTGGCCTGGAGGCTATCCAGCGTACTCCAAAGATTCAGGTTTACTCACGTCATCCAGCAGAGAATGGA	Seq Percent=71%

GGGGCATTCCTGAAGCTGACAGCATTCGGGCCGAGATGTCTCGCTCCGTGGCCTTAGCTGTGCTCGCGCTACTCTCTCTTTCTGGCCTGGAGGGTATCCAGCGTACTCCAAAGATTCAGGTTTACTCACGTCATCCAGCAGAGAATGGAAG	Seq Percent=151%

ATCTGTGGTAATTCTAGAGCTAATACATGCCGACGGGCGCTGACCCCCTTCGCGGGGGGGATGCGTGCATTTATCAGATCAAGACCTGCCCCGAC	Seq Percent=95%

CTGAGGCCTCAACGAGCACAACCACCACCTCATCAACGACTTCACCGTCAAGCAGATGAGACAAGGGGCCTTCCTGGTGAACACAGCCAG	Seq Percent=90%

CAGTACTCCAANGATTCAGGTTTACTCACGTCATCCAGCAGAGAATGGA	Seq Percent=49%

TCTCTGNCCCCTCTGCTGATGCCCCCATGTTCGTCATGGGNGTGAANCA	Seq Percent=49%

TTACTGGCCTGGAGGCTATCCAGCGTANTCCAAAGATTCAGGTTTACTCACTTCATCCAGCAGAGAATGGA	Seq Percent=71%

GGCCTACTTGTCGGATGGCGTGGAGCTGGCGCTGGGGCTGCAGCGTGTCAGCACCCTGCAGGACCTGCTCTTCCACAGCGACTGCGTGACCCTGCACTGCGGCCTCAACGAGCACAACCACCACCTCATCAACGACTTCACCGTCAAGCAG	Seq Percent=151%

AAGTAAACCAGGCATTCCCAAATTACTNGAAGGGAGTAAAAATTCAATACAGTGGGAGAAAGCTGAAGATAATGGATGTAGAATTACATACTATATCATTGAGATAAGAAAGAGCACTTCAAATAATTTACAGAACCAGAATTTAAGGAGG	Seq Percent=151%

CTCCAAAATCAAGTGGGGCGATGCTGGCGCTGAGTACGTCGTGGAGTCCACTGGCGTCTTCACCACCATGGAGAAGGCTGGGGCTCATTTGCAGGGGGGAGCCAAAGGGTCATCATCTCTGCCCCCTCTGCTGATGCCCCCATGTTCGTCA	Seq Percent=151%

AGACAACGGATTTGGTCGTATTGGGCGCATGGTCACCAGGGCTGCTTTTAACTCTGGTAATGTGGATATTGTTGCCATCAATGACCCCTTCATTGACCTCAACTAAATGGTTTACATGTTCCAATATGATTCCACCCATGGCAAATTCCAT	Seq Percent=151%

TGGGGCATTCCTGAAGCTGACAGCATTCAGGCCGAGATGTCTCGCTCCGTGGCCTTAGCTGTGCTCGCGCTACTCTCTCTTTCTGGCCTGGAGGCTATCCAGCGTACTCCAAAGATTCAGGTTTACTCACGTCATCCAGCAGAGAATGGAA	Seq Percent=151%

GGCATTCCTGAAGCTGACAGCATTCGGGCCGAGATGTCTCGCTCCGTGGCCTTAGCTGTGCTCACGCTACTCTCTCTTTCTGGCCTGGAGGCTATCCAGCGTACTCCAAAGATTCAGGTTTACTCACGTCATCCAGCAGAGAATGGAAGAA	Seq Percent=151%

CTGCCCCCTCTGCTGACGCCCCCATGTTCGTCATGGGTGTGAACCA	Seq Percent=46%

CATTTGCTGGGGGGAGCCAAAAGGGTCATCATCTCTGCCCCCTCTGCTGACGCCCCCATGTTCGTCATGGGTGTGAACCA	Seq Percent=80%

ACTTGCCTGGAGGCTATCCAGCGTACTCCAAAGATTCAGGTTTACTCACGTCATCCAGCAGAGAATGGA	Seq Percent=69%

CGTGGCCTTAGCTGTGCTCGCGCTACTCTCTCTTTCTGGCCTGGAGGTTATCCAGCGTACTCCAAAGATTCAGGTTTACTCACGTCATCCAGCAGAGAATGGA	Seq Percent=103%

ATTTCTGGCCTGGAGGCTGTCCAGCGTACTCCAAAGATTCAGGTTTACTCACGTCATCCAGCAGAGAATGGA	Seq Percent=72%

TTCTGGCCTGGAGGCTATCCAGCGTACTCCAAAGATTCAGGTTTACTCACGTCGTCCAGCAGAGAATGGA	Seq Percent=70%

TCACGGCCCTTACTTGTCGGATGGCGTGGAGCGGGAGCTGGGGATGCAGAGTGTCAGAACCATGCAGGAACTGATATTACACAGCGAGTGCGTGAAAATGAAATGAAGAATCAACGAGCACCACAAACACCTCATCAACGACATCACCGT	Seq Percent=150%

CTCAAGNGGGGCGATGCTGGCGCTGAGTACGTCGTGGAGTCCACTGGCGTCTTCACCACCATGGAGAAGGCTGGGGCTCATTTGCAGGGGGGAGCCAAAAGGGTCATCATCTCTGCCCCCTCTGCTGACGCCCCCATGTTCGTCATGGGTG	Seq Percent=151%

CTCAAGNGGGGCGATGCTGGCGCTGAGTACGTCGTGGAGTNCACTGNCGTCTTCACCACCATGGAGAAGGCTGGGGCTCATTTGCAGGGGGGAGCCAAAAGGGTCATCATCTCTGCCCCCTCTGCTGACGCCCCCATGTTCGTCATGGGTG	Seq Percent=151%

NTGTGGCCTGGAGGCTATCCAGCGTACTCCAAAGATTCAGGTTTACTCACGTCATCCAGCAGAGAATGGA	Seq Percent=70%

AGCTGAACAGGAGGCTATCCAGCGTACTCCAAAGATACAGGTTAACTCACGAAATACAGCAGAAAATGGAAGATCAGAAGAGCACACAACAGAACTAAAAACACGAATATAAATAGTATGCCGAATTAAACTAAAAAAAAAAAAAAAAAAA	Seq Percent=151%

CTTAGTGGCCTGGAGGCTATCCAGCGTACTCCAAAGATTCAGGTTTACTCACGTCATCCAGCAGAGAATGGA	Seq Percent=72%

GGGGCTTTCCTGAAGCTGACAGCATTCGGGCCGAGATGTCTCGCTCCGTGGCCTTAGCTGTGCTCGCGCTACTCTCTCTTTCTGGCCTGGAGGCTATCCAGCGTACTCCAAAGATTCAGGTTTACTCACGTCATCCAGCAGAGAATGGAAG	Seq Percent=151%

CGCTCTTTCTGGCCAGGAGGCTATCCAGCGTACTCCAAAGATTCAGGTTTACTCACGTCATCCAGCAGAGAATGGA	Seq Percent=76%

GGGGTAATGCTGGCGCTGAGTACGTCGTGGAGTCCACTGGCGTCTTCACCACCATGGAGAAGGCTGGGGCTCATTTGCAGGGGGGAGCCAAAAGGGTCATCATCTCTGCCCCCTCTGCTGATGCCCCCATGTTCGTCATGGGTGTGAACCA	Seq Percent=151%

GGGCATACCTGNAGCTGACAGCATTCGGGCCGAGATGTCTCGCTCCGTGGCCTTAGCTGTGCTCGCGCTACTCTCTCTTTCTGGCCTGGAGGCTATCCAGCGTACTCCAAAGATTCAGGTTTACTCACGTCATCCAGCAGAGAATGGA	Seq Percent=148%

GTGTGGCCTGGNGGCTATCCAGCGTACTCCAAAGATTCAGGTTTACTCACGTCATCCAGCAGAGAATGGA	Seq Percent=70%

AGCTGACGGCATTCGGGCCGAGATGTCTCGCTCCGTGGCCTTAGCTGTGCTCGCGCTACTCTCTCTTTCTGGCCTGGAGGCTATCCAGCGTACTCCAAAGATTCAGGTTTACTCACGTCATCCAGCAGAGAATGGA	Seq Percent=136%

CGACCCCTACTTGTCGGATGGCGTGGAGCGGGCGCTGGGGCTGCAGCGTGTCAGCACCCTGCAGGACCTGCTCTTCCACAGCGACTGCGTGACCCTGCACTGCGGCCTCAACGAGCACAACCACCACCTCATCAACGACTTCACCGTCAAG	Seq Percent=151%

NGGCATTCCTGAAGCTGACAGCATTCNNNCCGAGATGTCTCGCTCCGTGGCCTTAGCTGTGCTCGCGCTACTCTCTCTTTCTGGCCTGGAGGCTATCCAGCGTACTCCAAAGATTCAGGTTTACTCACGTCATCCAGCAGAGAATGGA	Seq Percent=148%

GGTTTTGGCAGTGGTTTTGACAACATCGACATCAAGTCGGCCGGGGATTTAGGAATTGCCGTCTGCAACGTACCCGCGGCGTCTGAGGAGGAGACTGCCGACTCGACGCTGTGCCACATCCTGAACCTGTACCGGCGGGCCACCTAGATGA	Seq Percent=151%

GGTTTTGGCAGTGGTTTTGACAACATCGACATCAAGTCGGCCGGGGATTTAGGCATTGCCGTCTGCAACGTGCCCGCGGCGTCTGAGGAGGAGACGGCCGACTCGACGCTGTGCCACATCCTGAACCTGAACCGGCGGGCCACCTGGCTG	Seq Percent=150%

TACTGACAGATCGGAAGAGCACACGTNNNNACTCCAGTCACGTGTTTATCTCGTATGCCGTCTTCTGCTTGAAAAAAAAAAAGAAAAAATAATAACAAAAAAGATAAAAAGAAGAAAAAAAAAAAAAAAAAAGAAAAAAAAAAAAAAAAAA	Seq Percent=151%

GTGGCTTCCTGAAGCTGACAGCATTCGGGCCGAGATGTCTNGCTCCNTGGCCTTAGCTGTGCTCGCGCTACTCTCTCTTTCTGGCCTGGAGGCTATCCAGCGTACTCCAAANATTCAGGNTTACTCACGTCATCCNNCAGAGAATGGANGA	Seq Percent=151%

TTCTTAATGGAGGCTATCCAGCGTACTACAAAGATTCAGGTTTACTCACGTCATACAGCAGAGAATGGA	Seq Percent=69%

GCTGGCGCTGAGTACGTCGTGGAGTCCACTGGCGTATTAACCACCATGGAGAAGGCTGGGGCTCATTTGAAGGGGGGAGCAAAAAGGGTCATCATATATGAACAAACTGAGGAAGCCCCCATGTTCGTAATGGNNGTGAACCA	Seq Percent=143%

CTTTTTGCCTGGAGGCTATCCAGCGTACTCCAAAGATTCAGGTTTACTCACGTCATCCAGCAGAGAATGGA	Seq Percent=71%

GATTCCGGTTTACTCACGTCATCCAGCAGAGAATGGA	Seq Percent=37%

GATTCCTGAAGCTGACAGCATTCGGGCCGAGATGTATCGCTCAGTGGCCTTAGCTGTGCTCGCGCTACTATCTCTTAAAGGCCTGGAGGCTATACAGAGTAATAGACAGAGAAAGGTTTACTCACGTCATCCAGCAGAGAATGTA	Seq Percent=145%

GATTCCTGAAGCTGACAGCATTCGGGCCGAGATGTATCGCTCAGTGGCCTTAGCTGTGCTCGCGCTACTATCTCTTGAAGGCCTGGAGGCTATACAGAGTAATAAACAGAGAAAGGTTTACTCACGTCATCCAGCAGAGAATGTA	Seq Percent=145%

GATTCCTGAAGCTGACAGCATTCGGGCCGAGATGTATCGCTCAGTGGCCTTAGCTGTGCTCGCGCTACTATCTCTTGAGGGCCTGGAGGCTATACAGAGTAATAAACGGAGAAAGGTTTACTCACGTCATCCAGCAGAGAATGTA	Seq Percent=145%

CACTCCAAAGATTCAGGTTTACTCACGTCATCCAGCAGAGAATGGA	Seq Percent=46%

TGCCTGGGGGCTATCCAGCGTACTCCAAAGATTCAGGTGTACACACGTCATCCAGCAGAGAATGGAAGATCGGAAGAGAAAACGTAAGAACTCAAGAAACGAGAGAATAAAGGATGCCGTCTTCTGCTAGAAAAAAAAAAAAGAAAAAAAA	Seq Percent=151%

CTCTTTCCGGCCTGGAGGCTATCCAGCGTACTCCAAAGATTCAGGTTTACTCACGTCATCCAGCAGAGAATGGA	Seq Percent=74%

TGATAGACAGGGGGCCTTCCTGGTGAANACAGCCCG	Seq Percent=36%

GGGGTATTTCTGAAGCTGACAGCATTCGGGCCGAGATGTCTCGCTCCGTGGCCTTAGCTGTGCTCGCGCTACTCTCTCTTTCTGGCCTGGAGGCTATCCAGCGTACTCCAAAGATTCAGGTTTACTCACGTCATCCAGCAGAGAATGGAAA	Seq Percent=151%

TTCTGGCTTGGAGGCTATCGAGCGTACTCCAAAGATTCGGGTTTACTCACGTAATCCAGCAGAGAAGGGA	Seq Percent=70%

TACCTTNCTTGTCGGATGGCGTGGAGCGGGCGCTGGGGGNNCAGCGNGTCAGAACCCTGCAGGACCGGCTCTTCCACAGCGACTGCGTGACCCTGCACNNCGGCCTCAACGNGCACAACNNCCACCTCATCAGCGNNGTCACCGTCAANCA	Seq Percent=151%

CTGCCCCCTCTGCTGACGCCCCCATGTTCGTCATGGGTGTGAACCA	Seq Percent=46%

GGGGCATTCCTGAAGCTGACAGCATTCGGGCCGAGATGTCTCGCTCCGTGGCCTTAGCTGTGCTCGCGCTACTCTCTCTTTCTGGCCTGGAGGCTATCCAGCGTACTCCAAAGATTCAGGTTTACTCACGTCAGCCAGCAGAGAATGGAAG	Seq Percent=151%

NTTTCTGGTCTGGAGGCTATCCAGCGTACTCCAAAGATTCAGGTTTACTCACGTCATCCAGCAGAGAATGGA	Seq Percent=72%

GGAGGCAATCCAGCGTACTCCAAAGATTCAGGTTTACTCACGTCATCCAGCAGAGAATGGA	Seq Percent=61%

CTTGGGCGATGCTGGCGCTGAGTACGTCGTGGAGTCCACTGGCGTCTTCACCACCATGGAGAAGGCTGGGGCTCATTTGCAGGGGGGAGCCAAAAGGGTCATCATCTCTGCCCCCTCTGNTGACGCCCCCATGTTNNTCATGGGTGTGNA	Seq Percent=150%

GATGCTGACAGCATTCGGGCCGAGATNNNTCGCTCCGTGGCCTTAGCTGTGCTCGCGCTACTCTCTCTTTCTGGCCTGGAGGCTATCCAGCGTACTCCAAAGATTCAGGTTTACTAAAGTCATCCAGCAGAGAATGGA	Seq Percent=138%

TCTTTCTGGCCTGGAGGCTATCCAGCGNACTCCAAAGATTCAGGTTTACTCACGTCATCCAGCAGAGAATGGA	Seq Percent=73%

GCCTTCCCTCGGGAAAAACTGACTCTGCGTCTCTTGCTGGGAAGTGGAGCCTTTGGAGAAGTGTATGAAGGAACAGCAGTGGACATCTTAGGAGTTGGAAGTGGAGAAATCAAAGCAGCAGTGAAGACTTTGAAGAAGGGTTCCACAGAC	Seq Percent=150%

CGCGTGGCCTGGAGGCTATCCAGCGTACTCCAAAGATTCAGGTTTACTCACGTCATCCAGCAGAGAATGGA	Seq Percent=71%

TTCTTGCTGGAGGCTATCCAGCGTACTNCAAAGATTCAGGTTTACTCACGTCATCCAGCAGAGAATGGA	Seq Percent=69%

TTTACTGGCCTGGAGGCTATCCAGCGTACTCCAAAGATTCAGGTTTACTCACGTCATCCAGCAGAGAATGGA	Seq Percent=72%

TGATTCAGGCATACTCACGTCATCCAGCAGAGAATGGA	Seq Percent=38%

ACTCCAAAGATTCAGGTTTACTCACGTCATCCAGCAGAGAATGGA	Seq Percent=45%

CTGCCCCCTCTGCTGACGCCCCCATGTTCGTCATGGGTGTGAACCA	Seq Percent=46%

TACTGCCTGGAGGCTATCCAGCGTACNNNAAAGATTCAGGTTTACTCACGTCATCCAGCAGAGAATGAA	Seq Percent=69%

GACAGCAATCGGGCCGAGATGTCTCGCTCCGTGGCCTTAGCTGTGCTCGCGCTACTCTCTCTTTCTGGCCTGGAGGCTATCCAGCGTACTCCAAAGATTCAGGTTTACTCACGTCATCCAGCAGAGAGTGGA	Seq Percent=132%

NTTTCTGGCCTGGAGGCTATCCAGCGNNNTCCAAAGATTCAGGTTTACTCACGTCATCCAGCAGAGAATGGA	Seq Percent=72%

GATCTGACCTGGAGGCTATCCAGCGTACTCCAAAGATTCAGGTTTACTCACGTCATACAGCAGAGAATGGA	Seq Percent=71%

GCTCTGGCCTGGAGGCTATCCAGCGTNNNNCAAAGATTCAGGTTTACTCACGTCATCCAGCAGAGAATGGA	Seq Percent=71%

CCAACATCAAGTGGGGCGATGCTGGCGCTGAGTACGTCGTGGAGTCCACTGGCGTCTTCACCACCATGGAGAAGGCTGGGGCTCATTTGCAGGGGGGAGCCAAAAGGGTCATCATCTCCGCCCCCTCTGCTGATGCCCCCATGTTCGTCAT	Seq Percent=151%

GGCAATGGAGGCTATCCAGCGTACTCCAAAGATTCAGGTTTACTCACGTCATCCAGCAGAGAATGGA	Seq Percent=67%

GCATTGGGGCCGAGATGTCTCGCTCCGTGGCCTTAGCTGTGCTCGCGCTACTCTCTCTTNCTGGCCTGGANGCTATCCAGCGTACTCCAAAGATTCAGGTTTACTCACGTCATCCAGCAGAGAATGGA	Seq Percent=128%

NGCTGAGTACGTCGTGGAGTCCACTGGCGTCTTCACCACCATGGAGAAGGCTGGGGCTCATTTGCAGGGGGGAGCCAAAAGGGTCATCATCTCTGCCCCCTCTGCTGACGCCCCCATGTTCGTCATGGGTGTGAACCA	Seq Percent=138%

TGCTGGCCTGGAGGCTATCCAGCGTACTCCAAAGATTCAGGTTTACTCACGTCATCCAGCAGAGAATGGA	Seq Percent=70%

CATTCTCTGGCCTGGAGGCTATCCAGCGTACTCAACAGATTCAGGTTTACTCACGTCATGAAGCAGAGAATGGAAGATCGTAAGACAACACGTATGACCTGGAGAGATGTGTTTATATCGTATGCCGTGTTCTGCTTGAAAAAAAAAAAAA	Seq Percent=151%

GCTGAGAACGGGAAGCTTGTCATCAATGGAAATCCCATCACCATCTTCCAGGAGCGAGATACCTCCAAAATCAAGTGGGGCGATGCTGGCGCTGAGTACGTCGTGGAGTCCACTGGCGTCTTCACCACCATGGAGAAGGCTGGGGCTCATT	Seq Percent=151%

NCAGTGCCTTAGCTGTGCTCGCGCTACTCTCTCTTTCTGGCCTGGAGGCTATCCAGCGTACTCCAAAGATTCAGGTTTACTCACGTCATCCAGCAGAGAATGGA	Seq Percent=104%

CTGATGACCTGGAGGCTATCCAGCGTACTCCAAAGATTCAGGTTTACTCACGTCATCCANCAGAGAATGGA	Seq Percent=71%

GATGTCACCATGTTCGTCATGGGTGTGAACCA	Seq Percent=32%

GGGCATGCTGAAGCTGACAGCATTCGGGCCGAGATGTCTCGCTCCGTGGCCTTAGCTGTGCTCGCGCTACTCTCTCTTTCTNGCCTGGAGGCTATCCANNGAACTCCAAAGATTCAGGNNNACTCACNTCNTCCAGCAGAGAATGGNNNAA	Seq Percent=151%

CAATGGGGCGATGCTGGCGCTGAGTACGTCGTGGAGTCCACTGGCGTCTTCACCACCATGGAGAAGGCTGGGGCTCATTTGCAGGGGGGAGCCAAAAGGGTCATCATCTCTGCCCCCTCTNCTGATGCCCCCATGTTCGTCATGGGTGNGA	Seq Percent=151%

TAGCCTGGAGGCTATCCAGCGTACTCAAAAGATTCAGGTTTACTCACGTCATCCAGCAGAGAATGGA	Seq Percent=67%

CACCGTCAGGCAGATGAGACAAGGGGCCTTCCTGGTGAACACAGCCCG	Seq Percent=48%

CGCGCTACTCTCTCTTTCTGGCCTGGAGGCTATCCAGCGTACTCCAAAGATTCAGGTTTACTCACGTCATCCAGCAGAGAATGGA	Seq Percent=85%

GGCCTTACCTGTGCTCGTGCTACTCTCTCTTTCTGGCCTGGAGGCTATCCAGCGTACTCCAAAGATTCAGGTTTACTCACGTCATCCAGCAGAGAATGGA	Seq Percent=100%

GATTCCTGAAGCTGACAGCATTCGGGCCGAGATGTCTCGCTCCGTGGCCTTATCTGTGCTCGCGCTACTCTCTCTTTCTGGCCTGGAGGCTATCCAGCGTACTCCAAAGATTCAGGTTTACTCACGTCATCCAGCAGAGAATGGA	Seq Percent=145%

GGGCTTTCCTGAAGCTGACAGCATTCGGGCCGAGATGTCTCGCTCCGTGGCCTTAGCTGTGCTCGCGCTACTCTCTCTTTCTGGCCTGGAGGCTATCCAGCGTACTCCAAAGATTCAGGTTTACTCACGTCATCCAGCAGAGAATGGA	Seq Percent=148%

CTGGTATTGTGGATATTGTTGCCATCAATGACCCCTTCATTGACCTCAACTACATGGTTTACATGTTCCAATATGATTCCACCCATGGCAAATTCCATGGCACCGTCAAGGCTGAGAACGGGAATCTTGTCATCAATGGAAATCCCATCA	Seq Percent=150%

CTGGTATTGTGGATATTGTTGCCATCAATGACCCCTTCATTGACCTCAACTACATGGTTTACATGTTCCAATATGATTCCACCCATGGCAAATTCCATGGCACCGTCAAGGCTGAGAACGGGAATCTTGTCATCAATGGAAATCCCATCA	Seq Percent=150%

GGCACCGTCAAGGCTGAGAACGGGAANNNTGTCATCAATGGAAATCCCATCACCATCTTCCAGGAGCGAGATCCCTCCAAAATCAAGTGGGGCGATGCTGGCGCTGAGTACGTCGTGGAGTCCACTGGCGTCTTCACCACCATGGAGAAGG	Seq Percent=151%

TGGGGCATTCCTGAAGCTGACAGCATTCGGGCCGAGATGTCTCGCTCCGTGGCCTTAGCTGTGCTCGCGCTACTCTCTCTTTCTGGCCTGGAGGCTATCCAGCGTACTCCAAAGATTCAGGTTTACTCACGTCANCCAGCAGAGAATGGAA	Seq Percent=151%

CTTCTTNCCTGGAGGCTATCCAGCGTACTCCAAAGATTCANGTTTANTCACGTCATCCAGCAGAGAATGGA	Seq Percent=71%

TTATTGGCCTGGAGGCTATCCAGCGTACTCCAAAGATTCAGGTTTACTCACGTCATCCAGCAGAGAATGGA	Seq Percent=71%

TGATTCAGGTTTACTCACGTCATCCAGCAGAGAATGGA	Seq Percent=38%

TTCTGGCCAGGAGGCTATCCAGCGTACTCCAAAGATTCAGGTTTACTCACGTCATCCAGCAGAGAATGGA	Seq Percent=70%

CCTTACGCGACACTCTTTCCCTACACGATGC	Seq Percent=31%

NGCCTGGGAGCAGCAGGGGGAGCAGGTGGGGTGGGGACGGGAGTACTGCTGGGGAAGGCACTGGGGAGGCTCATTGGCATCTGGAGGGACTCCATGCTCCTGTGCAGGCCTGAGAGTTTGGGGTACATGCGGGTCTCTTTTGGCACACTGA	Seq Percent=151%

CTGGGGCTGAGATGTCTCGCTCCGTGGCCTTAGCTGTGCTCGCGCTACTCTCTCTTTCTGGCCTGGAGGCTATCCAGCGTACTCCAAAGATTCAGGTTTACTCACGTCATCCAGCAGAGAATGGA	Seq Percent=125%

NTCTGGCCTGGAGGCTATCCAGCGTACTCCAAAGATTCAGGTTTACTCACGTCATCCAGCAGAGAATGGA	Seq Percent=70%

ACTCTGCCCCCTCTGCTGACGCCCCCATGTTCGTCATGGGTGTGAACCA	Seq Percent=49%

TGAATTCAGGTTTACTCACGTCATCCAGAAGAGAATGGA	Seq Percent=39%

CCATTACTTGTCGGATGGCGTGGAGCGGGCGCAGGTCCTGCAGGGTGCTGACACGCTGCAGGACCTGCTCTTCCACAGCGACTGCGTGACCCTGCACTGCGGCCTCAACGAGCACAACCACCACCTCATCAACGACTTCACCGTCAAGCAG	Seq Percent=151%

CCATTACTTGTCGGATGGCGTGGAGCGGGCGCAGGTCCTGCAGGGGGCTGACACGCTGCAGGACCTGCTCTTCCACAGCGACTGCGTGACCCTGCACTGCGGCCTCAACGAGCACAACCACCACCTCATCAACGACTTCACCGTCAAGCAG	Seq Percent=151%

TTGCTGGCCTGGAGGCTATCCAGCGTACTCCAAAGATTCAGGTTTACTCACGTCATCCAGCAGAGAATGGA	Seq Percent=71%

AGATTCAGGTTTACTCACGTCATCCAGCAGAGAATGGA	Seq Percent=38%

GGGCATTCCTGAAGCTGACAGCATTCGGGCCGAGATGTCTCGCTCCGTGGCCTTAGCTGTGCTCGCGCTACTCTCTCTTTCTGGCCTGGAGGCTATCCAGCGTACTCCAAAGATTCAGGTTTACTCACGTCATCCAGCAGAGAATGGA	Seq Percent=148%

GGTGACTCTAGATAACCTCGGGCCGATCGCACGCCCCCCGTGGCGGCGACGACCCATTCGAACGTCTGCCCTATCAACTTTCGATGGTAGTCGCCGTGCCTACCATGGTGACCACGTGTGACGGGGAATCAGGGTTCGATTCCGGAGAGGG	Seq Percent=151%

GTGGCCTGAGCTGTGCTCGCGCTACTCTCTCTTTCTGGCCTGGAGGCTATCCAGCGTACTCCAAAGATTCAGGTTTACTCACGTCATCCAGCAGAGAATGGA	Seq Percent=102%

NGTCAGCCGAGCCACATCGCTGAGACACCATGGGGAAGGTGAAGGTCGGAGTCAACGGATTTGGTCGTATTGGGCGCCTGGTCACCAGGGCTGTTTTTAACTCTGGTGAAGTGGATATTGTTGCCATCAACGACCCCTTCATTGACCTCAA	Seq Percent=151%

GATTTGGCCGTATTGGGCGCCTGGTCACCAGGGCTGCTTTTAACTCTGGTAAAGTGGATATTGTTGCCATCAATGACCCCTTCATTGACCTCAACTACATGGTTTACATGTTCCAATATGATTCCACCCATGGCAAATTCCATGGCACCGT	Seq Percent=151%

GATTTGGCCGTATTGGGCGCCTGGTCACCAGGGCTGCTTTTAACTCTGGTAAAGTGGATATTGTTGCCATCAATGACCCCTTCATTGACCTCAACTACATGGTTTACATGTTCCAATATGATTCCACCCATGGCAAATTCCATGGCACCGT	Seq Percent=151%

AGCCTAGAGGCTATCCAGCGTACTCCAAAGATTCAGGTTTACTCACGTCATCCAGCAGAGAATGGA	Seq Percent=66%

ACGGGCGATGCTGGCGCTGAGTACGTCGTGGAGTCCACTGGCGTCTTCACCACCATGGAGAAGGCTGGGGCTCATTTGCAGGGGGGAGCCAAAAGGGTCATCATCTCTGCCCCCTCTGCTGATGCCCCCATGTTCGTCATGGGTGTGAAC	Seq Percent=150%

GCCTGTGCTCGCGCTACTCTCTCTTTCTGGCCTGGAGGCTATCCAGCGTACTCCAAAGATTCAGGTTTACTCACGTCATCCAGCAGAGAATGGA	Seq Percent=94%

GGGTCTCTTGCTGGGAAGTGGAGCCTTTGGAGAAGTGTATGAAGGAACAGCAGTGGACATCTTAGGAGTTGGAAGTGGAGAAATCAAAGTAGCAGTGAAGACTTTGAAGAAGGGTTCCNNNGACCAGGAGAAGATTGAATTCCTGAGNNCG	Seq Percent=151%

NCTAAATGCCTCGTCATCTAATTAGTGACGCGCATGAATGGATGAACGAGATTCCCACTGTCCCTACCTACTATCCAGCGAAACCACAGCCAAGGGAACGGGCTTGGCGGAATCAGCGGGGAAAGAAGACCCTGTTGAGCTTGACTCTAGT	Seq Percent=151%

CTGCACGCCGGCCTCAACGAGCACAACCACCACCTCATCAACGACTTCACCGTCAAGCAGATGAGACAAGGGGCCTTCCTGGTGAGCACAGCCCG	Seq Percent=95%

TTGCTGGTAAGTGGAGCCTTTGGAGAAGTGTATGAAGGAACAGCAGTGGACATCTTAGGAGTTGGAAGTGGAGAAATCAAAGTAGCAGTGAAGACTTTGAAGAAGGGTTCCACAGACCAGGAGAAGATTGAATTNCTG	Seq Percent=138%

GGCCTTAGTTGTGCTCGCGCTACTCTCTCTTTCTGGCCTGGAGGCTACCCAGCGTACTCCAAAGATTCAGGTTTACTCACGTCATCCAGCAGAGAATGGA	Seq Percent=100%

GGCCTTAGTTGTGCTCGCGCTACTCTCTCTTTCTGGCCTGGAGGCTACCCAGCGTACTCCAAAGATTCAGGTTTACTCACGTCATCCAGCAGAGAATGGA	Seq Percent=100%

GTACTGCGGCCTCAACGAGCACAACCACCACCTCATCAACGACTTCACCGTCAAGCAGATGAGACAAGGGGCCTTCCTGGTGAACACAGCCCG	Seq Percent=93%

GGTCTGGGGGCTATCCAGCGTACTCCAAAGATTCAGGTTTACTCACGTCATCCAGCAGANAATGGA	Seq Percent=66%

NTGAACTGGCCCCTGCACCCGCGGCCCNTGGTGGCATTGCTGGATGGCCGGGACTGCACAGTGGAGATGCCCATCCTGAAGGACGTGGCCACTGTGGCCTTCTGCGACGCGCAGTCCACGCAGGAGATCCATGAGAAGGTCCTGAACGAGG	Seq Percent=151%

TTTCAGGTTTACTCACGTCATCCAGCAGAGAATGGA	Seq Percent=36%

TTTGCTGGGAAGTGGAGCCTTTGGAGAAGTGTATGAAGGAACAGCAGTGGACATCTTAGGAGTTGGAAGTGGAGAAATCAAAGTAGCAGTGAAGACTTTGAAGAAGGGTTCCACAGACCAGGAGAAGATTGAATTCCTG	Seq Percent=139%

TCTTCTGCACTGCGGCCTCAACGAGCACAACCACCACCTCATCAACGACTTCACCGTCAAGCAGATGAGACAAGGGGCCTTCCTGGTGAACACAGCCCG	Seq Percent=99%

NGCTTTCCTGAAGCTGACAGCATTCGGGACGAGATGTCTCGCTCCGTGGCCTTAGCTGTGCTCGCGCTACTCTCTCTTTCTGGCCTGGAGGCTATCCAGCGTACTCCAAAGATTCAGGTTTACTCACGTCATCCAGCAGAGAATGGA	Seq Percent=147%

GAGGCATGCCTGAAGCTGACAGCATTCGGGCCGAGATGTCTCGCTCCGTGGCCTTAGCTGTGCTCGCGCGACTCTCTCTTTCTGGCCTGGAGGCTATCCAGCGTACTCCAAAGATTCAGGTTTACTCACGTCATCCAGCAGAGAATGGAAG	Seq Percent=151%

TAATTACATGGATTACATGTTCCAATATGATTCCACCCATGGCAAATTCAATGGCACCGTCAAGGCTGAGAACGGGAAGCTTGTAATCAATGGAAATCCCATCACCATCTTCCAGGAGCGAGATACCTCCAAAAACAAGTGGAGCGATG	Seq Percent=149%

TTCTGGCCTGGAGGCTATCCAGCGTACTCCAAAGATTCAGGTTTACTCACGTCATCCAGCAGAGAATGGA	Seq Percent=70%

TTAACTCTGGTAAAGTGGATATTGTTGCCATCAATGACCCCTTCATTGACCTCAACTACATGGTTTACATGTTCCAATATGATTCCACCCATGGCAAATTCCATGGCACCGTCAAGGCTGATAACTGGAAGCTTGTCATCAATGGAAANC	Seq Percent=150%

CCCTTTCTGGCCTGGAGGCTATCCAGCGTACTCCAAAGATTCAGGTTTACTCACGTCATCCAGCAGAGAATGGA	Seq Percent=74%

TTCTGGACTGGAGGCTATCCAGCGTACTCCAAAGATTCAGGTTTAATAAAGTAATAGAGCAGAGAATGGAAGATAGGAAGAGCACAAGTATGAAATACAGTCAAGTGTTTATCTCGTATGCCGTCTTCTGCTTGAAAAAAAAAAAAAG	Seq Percent=148%

TTCTGGACTGGAGGCTATCCAGCGTACTCCAAAGATTCAGGTTTAATAACGTAATAAAGCAGAGAATGGAAGATAAGAAGAGCACAAGTCTGAAATACAGTCACGTGTTTATCTCGTATGCCGTCTTCTGCTTGAAAAAAAAAAAAAAAAA	Seq Percent=151%

CCGCTGGCCTGGAGGCTATCCAGCGTACTCCAAAGATTCAGGTTTACTCACGTGATACANAAGAGAATGGAAGATAGTCAGAGCACACGTATGAAATCCAGTAAAGTGTTTATCTCGTATGCCGTCTTCTGCTTGAAAAAAAAAAAAATAA	Seq Percent=151%

NCGCCTGGCGGCTATCCAGCGTACTCCAAAGATTCAGGTTTACTCACGTCATCCAGCAGAGAATGGA	Seq Percent=67%

ACGACCCTTACTTGTCGGATGGCGTGGAGCGGGCGCTGGGGCGGCAGCGTGTCAGCACCCTGCAGGACCTGCTCTTCCACAGCGACTGCGTGACCCTGCAATGCGGACTCAACGAGCAAAACCAACACCTCATCAACGACTTCACCGTCAA	Seq Percent=151%

ACGACCCTTACTTGTCGGATGGCGTGGAGCGGGCGCTGGGGCTGCAGCGTGTCAGCACCCTGCAGGACCTGCTCTTCCACAGCGACTGCGTGACCCTGCACTGCGGCCTCAACGAGCACAACCAACACCTCATCAACGACTTCACCGTCAA	Seq Percent=151%

CAGGTTTATTCACGTCATCCAGCAGAGAATGGA	Seq Percent=33%

TGTCTGGCCTGGAGGCTATCCAGCGTACTCCAAAGATTCAGGTTTACTCACGTCATCCAGCAGAGAATGGA	Seq Percent=71%

CTGCCCCCTCTGCTGATGCCCCCATGTTCGTCATGGGTGTGAACCA	Seq Percent=46%

CGCTGGCCTGGAGGCTATCCAGCGTACTCCAAAGATTCAGGTTTACTCACGTCATCCAGCAGAGAATGGA	Seq Percent=70%

AATCAAAATAAAGTGGGGAGATGCTGGNGCTGAGTACGACGTGGAGTCCACTGGCGTCTTCACCACCATGGAGAAGGAAGGGGCTAATTTGCAGGAGGGAGACAAAAGGGAAAACATCTCTGCCCCCTATGCTGATGCCCCCATGTTCGT	Seq Percent=150%

GGGGCATTCCTGAAGCTGACAGCATTCGGGCCGAGATGTCTCGCTCCGTGGCCTTAGCTGTGCTCGCGCTACTCTCTCTTTCTGGCCTGGAGGCTATCCAGCGTACTCCAAAGATTCAGGTTTACTCACGTCATCCAGCAGAGAATGGAAG	Seq Percent=151%

AAAAAGATAGATCGGAAGAGAAAAAGAATGAACTCCAGTCACGTGTTTATCTCGTATGCCGTCTTCTGCTTGAAAAAAAAAAAAGAAAAAAACAAAAAACATATAGAGAAAGAAAGAAAAACAATGATAAAAAGAAAAAAAAAAGAAGAAA	Seq Percent=151%

GCTCTTCTACGACCCTTACTTGTCGGATGGCGTGGAGCGGGCGCTGGGGCTGCAGCGTGTCAGCACCCTGCAGGACCTGCTCTTCCACAGCGACTGCGTGACCCTGCACTGCGGCCTCAACGAGCACAACCACCACCTCATCAACGACTT	Seq Percent=150%

AAAAATCCAAAATCAAGTGGGGAGATGATGGCGCTGAGTACGTCGTGGAGTCCACTGGCGTCTTCACCACCATGGAGAAGGCTGGGGCTCATTTGCAGGGGGGAGCCAAAAGGGTCATCATCTCTGCCCCCTCTGCTGACGCCCCCATGTT	Seq Percent=151%

NCACAGCGGAGATGCCCATCCTGAAGGNCGTGGCCACTGTGGCCTTCTGCGACGCGCAGTCCACGCAGGAGATCCATGAGAAGGTCCTGAACGAGGCTGTGGGGGCCCTGATGTACCACACCATCACTCTCACCAGGGAAGACCTGGAGAA	Seq Percent=151%

ATCCGCGGGGAGACCTTGGGCATCATCGGACTTGGTCGCGTGGGGCAGGCAGTGGCGCTGCGGGCCAAGGCCTTCGGCTTCAACGTGCTCTTCTACGACCCTTACTTGTCGGATGGCGTGGAGCGGGCGCTGGNNCTGCAGCGTGTCAGCA	Seq Percent=151%

ATGGCTGGAGGCTATCCAGCGTACTCCAAAGATTCAGGTTTACTCACGTCATCCAGCAGAGAATGGA	Seq Percent=67%

GTACCTNGGGCCACCTGGCTGCACCAGGCGCTGCGGGAGNNCACACNNGTCCAGAGCGTCGAGCAGATCCGCGAGGTGGCGTCCGGCGCTGCCAGGATCCGCGGGGAGACCTTGGGCATNATCGGACTTGGTCGCNNGGTGCAGGCAGNGG	Seq Percent=151%

GCGGGCCGAGATGTCTCGCTCCGTGGCCTTAGCTGTGCTCGCGCTACTCTCTCTTTCTGGCCTGGAGGCTATCCAGCGTACTGCAAAGATTCAGGTTTACTCACGTCATCCAGCAGAGAATGGAAGATCGGAANNGCACACGTCTGAACA	Seq Percent=150%

GGGGCATTCCTGAAGCTGACAGCATTCGGGCCGAGATGTCTCGCTCCGTGGCCTTAGCTGTGCTCGCGCTACTCTCTCTTTCTGGCCTGGAGGCTATCCAGCGTACTCCAAAGATTCAGGTTTACTCACGCCATCCAGCAGAGAATGGAAG	Seq Percent=151%

GGGGCATTCCTGAAGCTGACAGCATTAGGGCCGAGATGTCTCGCTCCGTGGACTTAGCTGTGCTCGCGCTACTCTCTCTTTCTGGCCTGGAGGCTATCCAGCGTACTCCAAAGATTCAGGTTTACTCACGTCATCCAGCAGAGAATGGAAG	Seq Percent=151%

GGGCATTCCTGAAGCTGACAGCATTCGGGCCGAGATGTCTCGCTCCGTGGCCTTAGCTGTGCTCGCGCTACTCTCTCTTTCTGGCCTGGAGGCTATCCAGCGTACTCCAAAGATTCAGGTTTACTCACGTCATCCAGCAGAGAATGGA	Seq Percent=148%

TGGGTTGCAAATATTCAAACGAGAACTTTGAAGGCCGAAGTGAAGAAGGGTTCCACAGACCAGGAGAAGATTGAATTCCTG	Seq Percent=81%

GACGGGCAGAGATGACTAGATCCGTAGACTTAGCTGTGATCGCGCTACTCTCTCTTTCTGGCCTGGAGGCTATCCAGCGTACTCCAAAGATTCAGGTTTACTCACGTCATCCAGCAGAGAATGGA	Seq Percent=125%

GAGCACAACCACCACCTCATCAACGACTTCACCGTCAAGCAGATGAGACAAGGGGCCTTCCTGGTGAACACAGCCCG	Seq Percent=77%

CTTCAGGCCTGGAGGCTACCCAGCGTACTCCAAAGATTCAGGTTTACTCACGTCATCCAGCAGAGAATGGA	Seq Percent=71%

NCCCCATCTGCTGACGCCCCCATGTTNNNCATGGGTGTGAACCA	Seq Percent=44%

NCCTTACTTGTCGGATGGCGTGGAGCGNGCGCTGGGGCTGCAGCGTGTCAGCACCCTGCAGGACCTGCTCTTCCACAGCGACTGCGTGACCCTGCACTGCGGCCTCAACGAGCACAACCACCACCTCATCAACGACTTCACCGTCAAGCAG	Seq Percent=151%

TTATTGACGGATGGCGTGGAGCGGGCGCTGGGGCTGCAGCGTGTCAGCACCCTGCAGGACCTGCTCTTCCACAGCGACTGCGTGACCCTGCACTGCGGCCTCAACGAGCACAACCACCACCTCATCAACGACTTCACCGTCAAGCAGATGA	Seq Percent=151%

NATTTGCAGGGGGGAGCCAAAAGGGTCATCATCTCTGCCCCCTCTGCTGATGCCCCCATGTTCGTCATGGGTGTGAACCA	Seq Percent=80%

CACGCTCCCGCCGTCTCTCAGGACCGACTGACCATGTTCAACTGCTGTTCACATGGAACCCTTCTCCACTTCGGCCTTCAAAGCTCTCGTTTGAATATTTGCTACTACCACCAAGACCTGCCCCGACGGAGGAAGAGCACACGTCTGAA	Seq Percent=149%

GGTCATTCCTGAAGCTGACGGCATTCGGGCCGAGATGTCTCGCTCCGTGGCCTTAGCTGTGCTCGCGCTACTCTCTCTTTCTGGCCTGGAGGCTATCCAGCGTACTCCAAAGATTCAGGTTTACTCACGTCATCCAGCAGAGAATGGA	Seq Percent=148%

GGGCATTCCTGAAGCTGACAGCATTCGGGCCGAGATGTCTCGCTCCGTGGCCTTAGCTGTGCTCGCGCTACTCTCTCTTTCTGGCCTGGAGGCTATCCAGCGTACTCCAAAGATTCAGGTTTACTCACGTCATCCAGCAGAGAATGGA	Seq Percent=148%

TACGTGGCCTTAGCTGTGCTCGCGCTACTCTCTCTTTCTGGCCTGGAGGCTATCCAGCGTACTCCAAAGATTCAGGTTTACTCACGTCATCCAGCAGAGAATGGA	Seq Percent=105%

TATATGGTGTTTCCCTACTCAGGCCTCCGGTTGCTCCTCCCTAGAGGGGCAGGATCTGCCTAGGAGGTGGTGGGGGCGTGTNGCGGGGCTCCCACATGNNTGACAGCCTGCTGTGTGTNNNGTGCAGGGANCACCNNGAACTTCTCNNN	Seq Percent=149%

ATCGACCCTTACTTGTCGGATGGCGTGGAGCGGGCGCTGGGGATGCAGCGTGTCAGCACCCTGCAGGACCTGCTCTTCCACAGCGACTGCGTGACCCTGCACTGCGGCCTCAACGAGCACAACCACCAACTCATCAACGACTTCACCGTCA	Seq Percent=151%

TTCTGCCTGGAGGCTATCCAGCGTACTCCAAAGATTCAGGTTTACTCACGTCATCCAGCAGAGAATG	Seq Percent=67%

AGCTACTCCAAAGATTCAGGTTTACTCACGTCATCCAGCAGAGAATGGA	Seq Percent=49%

GCACCGTCAAGGCTGAGAACGGGAAGCTTGTCATCAATGGAAATCCCATCACCATCTTCCAGGAGCGAGATCCCTCCAAAATCAAGTGGGGCGATGCTGGCGCTGAGTACGTCGTGGAGTCCACTGGCGTCTTCACCACCATGGAGAAGG	Seq Percent=150%

GCATTCCAGAAGCTGACAGCATTCGGGCCGAGATGTCTCGCTCCGTGGCCTTAGCTGTGCTCGCGCTACTCTCTCTTTCTGNCCTGGAGGCTATCCANNNTACTCCAAAGNTTNAGGTNNNCTCACGNCANCCCANNAGAGAATGGNNNAT	Seq Percent=151%

TTCTGGACTGGAGGCTATCCAGCGTACTCCAAAGATTCAGGTTTACTCACGTCATCCAGCAGAGAATGGA	Seq Percent=70%

TGGCCTTAGCTGTGCTCGCGCTACTCTCTCTTTCTGGACTGGAGGCTATCCAGCGTACTCCAAAGATTCAGGTGTACTCAAGTAATCCAGCAGAGAATGGAAGATAGGAAGAGCAAAGGTCTGAAATACAGACACGAGGTTAAATCGTATG	Seq Percent=151%

NTACTCCAAAGATTCAGGTTTACTCACNNCATCCAGCAGAGAATGGA	Seq Percent=47%

GGGGCATTCCTGAAGCTGACAGCATTCGGGCCGAGATGTCTCGCTCCGTGGAATTAGCTGTGCTCGCGCGACTCTCGCGTTCTGGGGTGGAGGCTATCCAGCGTACTCCAAAGATTCAGGTTTACTCACGTCATCCAGCAGAGAATGGNAG	Seq Percent=151%

GGGGCATTCCTGAAGCTGACAGCATTCGGGCCGAGATGTCTCGCTCCGTGGACTTAGCTGTGCTCGCGTGACTCTCGCGTTCTGGGCTGGAGGCTATCCAGCGCACTCCAAAGATTCAGGTTTACTCACGTCATCCAGCAGAGAATGGAAG	Seq Percent=151%

TTCTCGCCTGGAGGCTATCCAGCGTACTCCAAAGATTCAGGTTTACTCACGTCATCCAGNAGAGAATGGA	Seq Percent=70%

GAATTAATGAAGCTGACAGAATTCGGGCCGAGATGTCTCGCTCCGTGGCCTTAGCTGTGATAGCGCTACTCTATCTTTCTGGCCTGGAGGCTGTCCAGCGTACTCCAAAGATTCAGGTTTACTCACGTCATCCAGCAGAGAATGGA	Seq Percent=146%

CAAAAGGGTCATCATCTCTGCCCCCTCTGCTGATGCCCCCATGTTCGTCATGGGTGTGAACCA	Seq Percent=63%

NTGCCCCCTCTGCTGACGCCCCCATGTNNGTCATGGGTGTGAACCA	Seq Percent=46%

TTCTGGAAAGGAGGCTATCCAGCGTACTCCAAAGATTCAGGTTTACTCACGGAATAAAGAAGAGAATGGCAGATAGGAAGAGCACACGGATGACATCCAGTCACGTGTTTATCTCGTATGCCGTCTTCTGCTTGAAAAAAAAAAAAAAAAA	Seq Percent=151%

CTTTATGGTCTGGAGGCTATCCAGCGTACTCCAAAGATTCAGGTTTACTCACGTCATCCAGCAGAGAATGGA	Seq Percent=72%

CTTTATGGTCTGGAGGCTATCCAGCGTACTCCAAAGATTCAGGTTTACTCACGTCATCCAGCAGAGAATGGA	Seq Percent=72%

ATGATTGACAGATTGATAGCTCTTTCTCGATTCCGTGGGTGGTGGTGCATGGCCGTTCTTAGTTGGTGGATGAGAAGGCGC	Seq Percent=81%

NATTCCTGAAGCTGACAGCATTCGGGNNNAGATGTCTCGCTCCGTGGCCTTAGCTGTGCTCGCGCTACTCTCTCTTTCTGGCCTGGAGGCTATCCAGCGTACTCCAAAGATTCAGGTTTACTCACGTCATCCAGCAGAGAATGGA	Seq Percent=145%

CTGTGCTCGCGCTACTCTCTCTTTCTGGCCTGGAGGCTATCCAGCGTACTCAAAAGATTCAGGTTTACTCACGTCATCCAGCAGAGAATGGA	Seq Percent=92%

TTATGGCTGGAGGCTATCCAGCGTACTCCAAAGATTCAGGTTTACTCACGTCATCCAGCAGAGAATGGA	Seq Percent=69%

CTATTGACAGATGGCGTGGAGCGGGCGCTGGGGCTGCAGCGTGTCAGCACCCTGCAGGACCTGCTCTTCCACAGCGACTGNNGGACCCTGCACTGCGNNNACAACGAGCACNACCACCNNNTCATCAANGNCATANNCGGCAAGCANNNAA	Seq Percent=151%

GCATTTCTGAAGCTGACAGCATTCGGGACGAGATGTCTCGCTCCGTGGCCTTAGCTGTGCTCGCGCTACTCTCCCTTTCTGGCCTGGAGGCTATCCAGCGTACTCCAAAGATTCAGGTTTACTCACGTCATCCNGCAGAGAATGGA	Seq Percent=146%

TTCTGGCCTGGAGGCTATCCAGCGTACTACAAAGATTCAGGTTTACTCACGTCATCCAGCAGAGAATGGA	Seq Percent=70%

TTACTTGTCGGATGGCGTGGAGCGGGCGCTGGGGCTGCAGCGTGTCAGCACCCTGCAGGACCTGCTCTTCCACAGCAACTGCGTGACCCTGCACTGCGGCCTCAGCGAGCACAACCACCACCTCATCAACGACTTCACCGTCAAGCAGATG	Seq Percent=151%

NTGCACTAGTTGGCTTCTGACAAATGGAAAGTCCTGACACACTTGTGATTTACTGGGATATCCTGTGGCACCTCTCCAAGTTGGTGGTCTGCCCAGACACTCATTGCTGTGGTGATGCCAACACTCTACCATTTTCCAGCGTGGAAATACA	Seq Percent=151%

GGGGCATTCATGAAGCTGACAGCATTCGGGCAGAGATGTCTCGCTCCGTGGCCTTAGCTGTGCTCGCGCTACTATCTCTTTCTGGCCTGGAGGCTATCCAGCGTACTCCAAAGATTCAGGTTTACTCACGTCATCCAGCAGAGAATGGAAA	Seq Percent=151%

ACCTTAGCTGTGCTCGCGCTACTCTCTCTTTCTGGCCTGGAGGCTATCCAGCCTACTCCAAAGATTCAGGTTTACTCACGTCATCCAGCAGAGAATGGA	Seq Percent=99%

CACACCCACCACCCCATCAACGACTTCACCGTCAAGCAGATGAGACAAGGGGCCTTCCTGGTGAACACAGCCCG	Seq Percent=74%

CGTACTAAAAAGATTCAGGTTTACTCACGTATCCAGCAGAGAATGTA	Seq Percent=47%

CTCTGCCCCCTCTGCTGACGCCCCCATGTTCGTCATGGGTGTGAACCAAGATNGGAAGANNACACGTCTGNACTCCAGTCACGTGTNTATATCGTATGCCGTCTNNTGCTTGAAAANAAAAAAAAAAAAAAATAAATGAAAAAAAAACAAA	Seq Percent=151%

AAACTAAGTGGGGCGATGCTGGCGCTGAGTACGTCGTGGAGTCCACTGGCGTCTTCACCACCATGGAGAAGGCTGGGGCTCATTTGCAGGGGGGAGCCAAAAGGGTCATCATCTCTGCCCCCTCTGCTGATGCACCAATGTTCGTCATGGG	Seq Percent=151%

CTTTCTGGCCTGGAGGCTATCCAGCGTACTCCAAAGATTCAGGTTTACTCACGTCATCCAGCAGAGAATGGA	Seq Percent=72%

CACTTTCTGGCCTGGAGGCTATCCAGCGTACTCGAAAGATTCAGGTTTACTCACGTCATNCAGCAGAGAANGGA	Seq Percent=74%

GGACCGCGGCGTCTGTGGAGGAGACGGCCGACTCGACGCTGTGCCACATCCTGAACCTGTACCGGCGGACCAACTGGCTGCAACAAGGGCGACGGGAGGGAACACAAGTCCAAAGCGTCGAACAGAACCGCGAGGTGTCGTCCGGCGCTAG	Seq Percent=151%

CGTATGTGGAGGAGACGGCCGACTAGACGCTGTGCCACATCCTGAAACTGTACAGGAGGGACAAAAGGCTGCAACAAGCGCAGCGGGAAGGAAAAAGAATACAGAAAGTCGAGAAAAAACACGAAGGGGGAGCCGGCGCTGACAGGAACCG	Seq Percent=151%

CCTGACCTGGAGGCTATCCAGCGTACTCCAAAGATTCAGGTTTACTCACGTCATCCAGCAGAGAATGGA	Seq Percent=69%

GATTCCTGGAGCTGACAGCATTCGGGCCGAGATGTCTCGCTCCGTGGCCTTAGCTGTGCTCGCGCTACTCTCTCTTTCTGGCCTGGAGGCTATCCAGCGTACTCCAAAGATTCAGGTTTACTCACGTCATCCAGCAGAGAATGGA	Seq Percent=145%

GAACTGGCCTGGAGGCTATCCAGCGTACTCCAAAGATTCAGGTTTACTCACGTCATCCAGCAGAGAATGGA	Seq Percent=71%

CCCATCACCATCTTCCAGGAGCGAGATCCCTCCAAAATCAAGTGGGGCGATGCTGGCGCTGAGTACGTCGTGGAGTCCACNGGCGTCTTCACCACCATGGAGAAGGCTGGGNCTCATTTNCAGGGGGGAGCCAAANNGGTCATCATCTNTG	Seq Percent=151%

AACTTCAACTACATGGTTTACATGTTCCAATATGATTCCACCCATGGCAAATTCCATGGCACCGTCAAGGCTGAGAACGGGAAGCTTGTCATCAATGGAAATCCCATCACCATCTTCANNNAGCGAGATCCCTCCAAAATCAAGTGGGNCG	Seq Percent=151%

GGCTTTCTAGGCGGGTGTCCCCTTCCTCCCTCACCGCTCCATGTGCGTCCCTCCCGAAGCTGCGCGCTCGGTCGAAGAGGACGACCATCCCCGATAGAGGAGGACCGGTCTTCGGTCAAGGGTATACGAGTANNTGCGCTCCCCTGCTATG	Seq Percent=151%

GTGGCATTCGGGCCGAGATGTCTCGCTCCGTGGCCTTAGCTGTGCTCGCGCTACTCTCTCTTTCTGGCCTGGAGGCTATCCAGCGTACTCCAAAGATTCAGGTTTACTCACGTCATCCAGCATAGAATGGA	Seq Percent=131%

GTGGCATTCGGGCCGAGATGTCTCGCTCCGTGGCCTTAGCTGTGCTCGCGCTACTCTCTCTTTCTGGCCTGGAGGCTATCCAGCGTACTCCAAAGATTCAGGTTTACTCACGTCATCCAGCAGAGAATGGA	Seq Percent=131%

CTTCAAAATCAAGTGGGGCGATGCTGGCGCTGAGTACGTCGTGGAGTCCACTGGCGTCTTCACCACCATGGAGAAGGCTGGGGCTCATTTGCAGGGGGGAGCCAAAAGGGTCATCATCTCTGCCCCCTCTGCNGNCGCCCCCATGTTCGT	Seq Percent=150%

CCGAGCCCTCTGCTGACGCACCCATGTTCGTCATGGGTGTGAACCA	Seq Percent=46%

CCTTTCGGCCTGGAGGCTATCCAGCGTACTCCAAAGATTNNGGTTTNNTCACGTCATCCAGCAGAGAATGGA	Seq Percent=72%

TTTTCAGGCCTGGAGGCTATCCAGCGAACTCCACAGATTAAGGTTTACTCACGTCATCCAGCAGAGAATGGA	Seq Percent=72%

CACCTGGTATGACAACGAATTTGGCTACAGCAACAGGGTGGTGGACCTCATGGCCCACATGGCCTCCAAGGAGTAAGACCCCTGGACCACCAGAAATCCCATCACCATCTTCCAGGAGCGAGATCCCTCCAAAATCAAGAGGGGCGATG	Seq Percent=149%

CACCTGGTATGACAACGAATTTGGCTACAGCAACAGGGTGGTGGACCTCATGGCCCACATGGCCTCCAAGGAGTAAGACCCCTGGACCACCAGAAATCCCATCACCATCTTCCAGGAGCGAGATCCCTCCAAAATCAAGTGGGGCGATG	Seq Percent=149%

CACCTGGTATGACAACGAATTTGGCTACAGCAACAGGGTGGTGGACCTCATGGCCCACATGGCCTCCAAGGAGTAAGACCCCTGGACCACCAGAAATCCCATCACCATCTTCCAGGAGCGAGATCCCTCCAAAATCAAGTGGGGCGATG	Seq Percent=149%

AAAAAAAAAAGAGGGGCGAAGCTGGCGATGAGTACGTCGTGGAGTCCACTGGCGTCTTCACCACCATGGAGAAGGCTGGGGCTCATTTGCAGGGGGGAGCCAAAAGGGTCATTATCTCTGCCCCCTCTGCTGACGCCCCCATGTTCGTCAT	Seq Percent=151%

AAAAAAAAAAGAGGGTCGAAGCTGGCGAAGAGTACGTCGTGGAGTCGACTGGCGTCTTCACCACCATGGAGAAGGCTGGGGCTCATTTGCAGGGGGGAGCCAAAAGGGTCATTATCTCTNCCCCCTCTGCTGACGCCCCCATGTTCGTCAT	Seq Percent=151%

GTGGTTCCTTTGGTCGCTCGCTCCTCTCCTACTTGGATAACTGTGGTAATTCTAGAGCTAATACATGCCGACGGGCGCTGACCCCCTTCGCGGGGGGGATGCGTGCATTTATCAGATCAAAACCAACCCGGTNNGCCCCTNNCCGGCCCCN	Seq Percent=151%

GGGCATTGCTGAAGCTGACAGCATTCGNGCCGAGATGTCTCGCTCCGTGGCCTTAGCTGTGCTCGCGCTACTCTCTCTTTCTGGCCTGGAGGCTATCCAGCGTACTCCAAAGATTCAGGTTTACTCACGTCATCCAGCAGAGAATGGA	Seq Percent=148%

NGCAAATAAGACAAGGGGCCTTCCTGGTGAACACAGCCCG	Seq Percent=40%

TTCTGCCCTGGAGGCTATCCAGCGTACTCCAAAGATTCAGGTTTACTCACGTCATCCAGCAGAGAATGGA	Seq Percent=70%

TGTGCCTCTTTGTATGAATCACTAACCTCACTGTACCTTAGCTGTAACATCTGTTAAATGAGGAAATCAGGCTAGAAATTTTGAACTCCACCCCACCCTGCCCTTTCTTCTAATGAAATNTTACTTGAAGCATGAACAAAAAAATTACNGG	Seq Percent=151%

ACAGTACAGTGGGAGAAAGCTGAAGATAATGGATGTAGAATTACATACTATATCCTTGAGATAAGAAAGAGCACTTCAAATAATTAACAGAACCAGAATTTAAGGTAGAAGATG	Seq Percent=114%

AGCTGGCCTGGAGGCTATCCAGCGTACTCCAAAGATTCAGGTTTACTCACGTCATCCAGCAGAGAATGGA	Seq Percent=70%

CACGCTTACTTGTCGGATGGCGTGGAGCGGGCGCTGGGGCTGCAGCGTGTCAGCACCCTGCAGGACCTGCTCTTCCACAGCGACTGCGTGACCCTGCACTGCGGCCTCAACGAGCACAACCACCACCTCATCAACGACCTCACCGTCAAG	Seq Percent=150%

GGGCATTACTGAAGCTGACATCATTCGGGCCGAGATGTCTCGCTCCGTGGCCTTAGCTGTGCTCGCGCTACTCTCTCTTTCNNGCCTGGAGGCTATCCNGCGTACTCCAAAGATTCAGNNNTACTCNCGTCATCNAGNAGAGAATNNNNAA	Seq Percent=151%

TTCTGGCCTGGAGGCTATCCAGCGTACTCCAAAGATTCAGGTTTACTCACGTCATCCAGCAGAGAATGGA	Seq Percent=70%

GGGCATTTCTGAAGCTGACAGCATTCGGGCCGAGATGTCTCGCTCCGTGGCCTTAGCTGTGCTCGCGCTACTCTCTCTTTCTGGCCTGGAGGCTATCCAGCGTACTCCAAAGATTCAGGTTTACTCACGTCATCCAGCAGAGAATGGA	Seq Percent=148%

CTGCCCCCTCTGCTGATGCCCCCATGTTCGTCATGGGTGTGAACCA	Seq Percent=46%

NCAAATTCAAGTGGGGCGATGCTGGCGCTGAGTACGTCGTTTATTCCACTTTCGTCTTCACCACCATGTATAAGGCTGGGGCTCATTTTCATTGTGGAGCCACAAGGGTCATCATCTCTGCCCCCTCTGCTGACGCCCCCATGTTCGTCAT	Seq Percent=151%

NCAAATTCAAGTGGGGCGATGCTGGCGCTGAGTACGTCGTGGAGTCCACTGTCGTCTTCACCACCATGGATAATTCTGGGGCTCATTTTCAGGGGGGAGCCAAAAGGGTCATCATCTCTGCCCCCTCTGCTGACGCCCCCATGTTCGTCAT	Seq Percent=151%

CCAAAGATTCAGGTTTACTCACGTCATCCAGCAGAGAATGGA	Seq Percent=42%

CGACCCTGCACTGCGGCCTCAACGAGCACAACCACCACCTCATCAACGACTTCACCGTCAAGCAGATGAGACAAGGGGCCTTCCTGGTGAACACAGCCCG	Seq Percent=100%

TTCTGGCTGGAGGCTATCCAGCGTACTCCAAAGATTCAGGTTTACTCACGTCATCCAGCAGAGAATGGA	Seq Percent=69%

TTTCTAGGCCTGGAGGCTATCCAGCGTACTCCAAAGATTCAGGTTTACTCACGTCATCCAGAAGAGAATGGA	Seq Percent=72%

CAAATGGGGCGATGATGGCGCTGAGTACGTCGTGGAGTCCACAGGCGTCTTCACCACCATGGAGAAGGCTGGGGCTCATTTGCAGGGGGGAGCCAAAAGGGTCATTATCTCTGCCCCCTCTGCTGATGCCCCCATGTTCGTCATGGGTGTG	Seq Percent=151%

GGGGCATTCCTGAAGCTGACAGCATTCGGGCCGAGATGTCTCGCTCCGTGGCCTTAGCTGTGCTCGCGCTACTCTCTCTTTCTGGCCTGGAGGCTATCAAGCGTACTCCAAAGATTCAGGTTTACTCACGTCATCCAGCANNGNATGGAAA	Seq Percent=151%

NTTCTGGCCTGGAGGCTATCCAGCGTACTCCAAAGATTCAGGTTTACTCACGTCATCCAGCAGAGAATGGA	Seq Percent=71%

TTGCATTCCTGAAGCTGACAGCATTCGGGCCGAGATGTCTCGCTCCGTGGCCTTAGCTGTGCTCGCGCTACTCTCTCTTTCTGGCCTGGAGGCTATCCAGCGTACTCCAAAGATTAAGGTTTACTCACGTCAGACAGAAGAGAATGGA	Seq Percent=148%

NTCTATTCTGGGGGCTATCCAGCGTACNCCAAAGATTCAGGTTTACTCACGTCATCCAGCAGAGAATGGA	Seq Percent=70%

CCAGGGGGCATTCCTGAAGCTGACAGCATTCGGGCCGAGATGTATCGCTACGTGGAATTAGCTGTGCTCGCGCTACTCTCTATTTATGGCCTGGAGGATATCCAGCGTACTCCAAAGATTCAGGTTTACTCACGTCATCCAGCAGAGAATG	Seq Percent=151%

TTCTGGCCTGGAGGCTATCCAGCGTACTCCAAAGATTCAGGTTTACTCACGTCATCCAGCAGAGAATGGA	Seq Percent=70%

TTCTGGGCTGGAGGCTATCCAGCGTACTCCAAAGATTCAGGTTTACTCACGTCATCCAGCAGAGAATGGA	Seq Percent=70%

GTGCTCCAGAGATTCAGGTTTACTCACGTCATCCAGCAGAGAATGGA	Seq Percent=47%

NGGCATTCCTGAAGCTGACAGCATTCGGGCCGAGATGTCTCGCTCCGTGGCCTTAGCTGTGCTCGCGCTACTCTCTCTTTCTGGCCTGGAGGCTATCCAGCGTACCCCAAAGATTCAGGTTTACTCACGTCATCCAGCAGAGAATGGA	Seq Percent=148%

CTACTGGCCTGGAGGCTATCCAGCGTACTCCAAAGATTCAGGTTTACTCACGTCATCCAGCAGAGAATGGA	Seq Percent=71%

AGACCTGGGGCCTTCCTGGTGAACACAGCCCG	Seq Percent=32%

CTGGCCTGGAGGCTATCCAGCGTACTCCAAAGATTCAGGTTTACTCACGTCATCCAGCANAGAATGGA	Seq Percent=68%

CATCCTGGCCTGGAGGCTATCCAGCGTACTCCAAAGGTTCNGGTTTNCTCACGTCATCCAGAAGAGAATGGA	Seq Percent=72%

TAACTTTCGGATGGCGTGGAGCGGGCGCTGGGGCTGCAGCGTGTCAGCACCCTGCAGGACCTGCTCTTCCACAGCGACTGCGTGACCCTGCACTGCGGCCTCAACGAGCACAACCACCACCTCATCAACGACTTCACCGTCAAGCAGATGA	Seq Percent=151%

NGGGCATTCCTGAAGCTGACAGCATTCGGGCCGAGATGTCTCGCTCCGTGGCCTTAGCTGTGCTCGCGCTACTCTCTCTTTCTGGCCTGGAGGCTATCCAGCGTACTCCAAAGATTCAGGTTTACTCGCGTCATCCAGCAGAGAATGGAAG	Seq Percent=151%

GATTCCTGGAGCTGACAGCATTCGGGCCGAGATGTCTCGCTCCGTGGCCTTAGCTGTGCTCGCGCTACTCTCTCTTTCTGNCCTGGAGGCTATCCAGCGTACTCCAAAGATNCAGGTTTNCTCACGTCATCCAGCNNAGAATGGA	Seq Percent=145%

ACCGATTGCGTGACCCTGCACTGCGGCCTCAACTAGCACAACCACCACCTCATCAACGACTTCACCGTCAAGCAGATGAGACAAGTGTCCTTCCTGGTGAACACAGCCCG	Seq Percent=110%

CCTAAGCTGTGCTCGCGCTACTCTCTCTTTCTGGCCTGGAGGCTATCCAGCGTACTCCAAAGATTCAGGTTTACTCACGTCATCCAGCAGAGAATGGA	Seq Percent=98%

TCTGGCATGGAGGCTATCCAGCGGACTACAAAGATTCAGGTTTACTCACGTCATCCAGCAGAGAATGGA	Seq Percent=69%

ATCCCTTACTTGTCGGATGGCGTGGAGCGGGCGCTGGGGCTGCAGCGTGTCAGCACCCTGCAGGACCTGCTCTTCCACAGCGACTGCGTGACCCTGCACTGCGGCCTCAACGAGCACAACCACCACCTCATCAACGACTTCACCGTCAAG	Seq Percent=150%

TGGCGTCTTCACCACCATGGAGAAGGCTGGGGCTCATTTGCAGGGGGGAGCCAAAAGGGTCATCATCTCTGCCCCCTCTGCTGATGCCCCCATGTTCGTCATGGGTGTGAACCA	Seq Percent=114%

CTGGAGGCTATCCAGCGTACTCCAAAGATTCAGGTTTACTCACGTCATCCAGCAGAGAATGGA	Seq Percent=63%

NAATTCAGGTTTACTCACGTCATCCAGCAGAGAATGGA	Seq Percent=38%

TTCTGGCCTGGAGGCTATCCAGCGTACTCCAAAGATTCAGGTTTACTCACGTCATCCAGCAGAGAATGGA	Seq Percent=70%

GGTTGACTCACGTCATCCAGCAGAGAATGGA	Seq Percent=31%

ACTGGCCTGGAGGCTATCCAGCGTACTCCAAAGATTAAGGTTTACTCACGTCATCCAGCAGAGAATGGA	Seq Percent=69%

TTCTGGCCTGGAGGCTATCCAGCGTACTCCAAAGATTAAGGTTTACTCACGTCATCCAGCAGAGAATGGA	Seq Percent=70%

TTCTGGCCTGGAGGCTATCCAGCGTACCCCAAAGATTCAGGTTTACTCACGTCATCCAGCAGAGAATGGA	Seq Percent=70%

NCCGTACTCCAAAGATTCAGGTTTACTNNCGTCATCCAGCAGAGAATGGA	Seq Percent=50%

GCGGCCTCAACGAGCACAACCACCACCTCATCAACGACTTCACCGTCAAGCAGATGAGACAAGGGGCCTTCCTGGTGAACACAGCCCG	Seq Percent=88%

CAGTTACATGGTTTACATGTTCCAATATGATTCCACCCATGGCAAATTCCATGGCACCGTCAAGGCTGAGAACGGGAAGCTCGTCATCAATGGAAATCCCATCACCATCTTCCAGGAGCGAGATCCCTCCAAANTCAAGTGGGGCGATG	Seq Percent=149%

CAGTTACATGGTTTACATGTTCCAATATGATTCCACCCATGGCAAATTCCATGGCACCGTCAAGGCTGAGAACGGGAAGCTCGTCATCAATGGAAATCCCATCACCATCTTCCAGGAGCGAGATCCCTCCAANNNCAAGTGNGTCGATGCN	Seq Percent=151%

NGGTATTCCTGAAGCTGACAGCATTCGGGCCGAGATGTCTCGCTCCGTGGCCTTAGCTGTGCTCGCGCTACTCTCTCTTTCTGGCCTGGGGGCTATCAAGCGTACTCCAAAGATTCAGGTTTACTCACGTCATCCAGCAGAGAATGGAAAA	Seq Percent=151%

GGTCTTGGAGGCTATCCAGAGAAAAGGAAGGATTCAGGTTTACTCACGTCATCCAGCAGNGAATGGA	Seq Percent=67%

AAAAAAAAAAAAAAGGAAAAGAGAATAAGAAAGAAGAAAAAGTAAAAATAAAAAGAGAAAAAAAAAAAAAACAAAAAAAAAATGAAAAGAAAGAAAAAAACAAAACAAAAAAAAAAAAAGAAAAAAAAAAAAAAAAAAAAAAAAAAAGAA	Seq Percent=150%

NCCGGCTTCAACGTGCTCTTCTACGACCCTTACTTGTCGGATGGCGTGGAGCGGGCGCTGGGGCTGCAGCGTGTCAGCACCCTGCAGGACCTGCTCTTCCACAGCGACTGCGTGACCCTGCACTGCGGCCTCAACGAGCACAACCACCAC	Seq Percent=150%

NGATCCCACCAAAATCAAGTGGGGCGANGCTGGCGCTGAGTACGTCGTGGGGTCCACTGGCGTCTTCACCACCATGGAGAAGGCTGGGGCTCATTTGCAGGGGGGAGCCAAAAGGGTCATCATCTCTGCCCCCTCTGCTGACGCCCCCATG	Seq Percent=151%

GGGCATTCCTGAAGCTGACAGCATTCGGGCCGAGATGTCTCGCTCCGTGGCCTTAGCTGTGCTCGCGCTACTCTCTCTTTCTGGCCTGGAGGCTATCCAGCGCACTCCAAAGATTCAGGTTTACTCACGTCATCCAGCAGAGAATGGA	Seq Percent=148%

TTCTGGCCTGGAGGCTATCCAGCGTANNNCAAAGATTCAGGTTTACTCACGTCATCCAGCAGAGAATGGA	Seq Percent=70%

ACTTGCCTCTGGCCAAGACAAACCTCACATGGTATGGCATCACCAGCCCTACTCCAACATACCTGGTTTATTATGCAGAAGTTAATGACAGGAAAAACAGCTCTGACTTGAAATATAAAATTCTAGAATTTCAGGACAGTATAGCTCTTAT	Seq Percent=151%

NCTTGCCTCTGGCCAAGACAAACCTCACATGGTATGGCATCACCAGCCCTACTCCAACATACCTGGTTTATTATGCAGAAGTTAATGACAGGAAAAACAGCTCTGACTTGAAATATAGAATTCTGGAATTTCAGGACAGTATAGCTCTTAT	Seq Percent=151%

ACATGACTCTGGACAAGACAAACCTCACATGATATGGAATCACCAGCCCTACTCCAACATAACTGGTTTATTATGCAGAAGTTAATGACAGGAAAAACAGCTCTGACTTGAAATATAGAATTCTGGAATTTCAGGACAGTATAGCTCTTAT	Seq Percent=151%

GCATTCCTGAAGCTGACAGCATTCGGGCCGAGATGTCTCGCTCCGTGGCCTTAGCTGTGCTCGCGCTACTCTCTCTTTCTGGCCTGGAGGCTATCCAGCGTACTCCAAAGATTCAGGTTTACTCACGTCATCCAGCAGAGAATGGA	Seq Percent=146%

GGCGACTACAAAGATTCAGGTTTACTCACGTCATNCAGCAGAGNATGGA	Seq Percent=49%

GGCACTCCAGAAGCTGACAGCATTCGGGCCGAGATGTCTCNCTCCGNGGCCTTAGCTGTGCTCGCGCTACTCTCTCTTTCTGGCCTGTAGGCTATCCAGCGTACTACAAAGATTCAGGTNTACTCACGTCATCCAGCAGAGAATGGA	Seq Percent=147%

TAAGTGGAAATCTTAGGAGTTGGAAGAGGAGAAATCAAAGTAGCAGTGAAGACTTTGAAAAAGGGTTCCACAGACCAGGAGAAGATTGAATTCCTG	Seq Percent=96%

TTCTCGGCCTGGAGGCTATCCAGCGTACTCCAAAGATTCAGGTTTACTCACGTCATCCAGCAGAGAATGGA	Seq Percent=71%

TATTTGTCGGATGGCGTGGAGCGGGCGCTGGGGCTGCAGCGTGTCAGCACCCTGCAGGACCTGCTCTTCCACAGCGACTGCGTGACCCTGCACTGCGGCCTCAACGAGCACAACCACCAACTCATCAACGACTTCACCGTCAAGCAGATGA	Seq Percent=151%

TTCTGGCCTGGAGGCTATCAAGAGTACTACAAAGATTCAGGTTTACTCACGTCATCCAGCAGAGAATGGA	Seq Percent=70%

GGTTTACTCACGTCATCCAGCAGAGAATGGA	Seq Percent=31%

NATCAGGTGGGGCGATGCTGGCGCTGAGTACGTCGTGGAGTCCACTGGCGTCTTCACCACCATGGAGAAGGCTGGGGATCATTTGAAGGGGGGAGCCACGAGGGTAATCAGATGTGCCCCCGCTGCTGATGCCCCCATGTTCGTCATGGGT	Seq Percent=151%

TTCTGGCCTGGAGGCTATCCAGCGTACTCCAAAGATTGAGGTTTACTCACGTCATCCAGCAGAGAATGGA	Seq Percent=70%

TACTCGTTGGATGGCGTGGAGCGGGCGCTGGGGCTGCAGCGTGTCAGCACCCTGCAGGACCTGCTCTTCCACAGCGACTGCGTGACCCTGCACTACGGCCTCAACGAGCACAACCACCACCTCATCAACGACNNAACCGTCAAGCAGATGN	Seq Percent=151%

CAAAATCAGGTGGGGCGATGCTGGCGCTGAGTACGTCGTGGAGTCCACTGGCGTCTTCACCACCATGGAGAAGGCTGGGGCTCATTTGCAGGGGGGAGCCAAAAGGGTCATCATCTNTGCCCCCNCTGCTGATGCCCCAANNTNAGTCATG	Seq Percent=151%

GAGGGTAGTATATTCTTAAGTGGCGCAAGCACAGCCAAATCGCTGAGACACCCTCTTTAAAGTGAATATCTTAGTGAAAGGAAAGGGTAGTATGGAGCGGCTGGTCAGCAGGGCGGGTTATAACTCTGGTAAAGTGGATATGGTTGCAAT	Seq Percent=150%

CCTACGACCCTTACTTGTCGGATGGCGTGGAGCGGGCGCTGGGGCTGCAGCGTGTCAGCACCCTGCAGGACCTGCTCTTCCACAGCGACTGCGTGACCCTGCACTGCGGCCTCAACGAGCACAACCACCACCTCATCAACGACTTCACCGT	Seq Percent=151%

CGGGGCATTCCTGAAGCTGACAGCATTCGGGCCGAGATGTCTCGCTCCGTGGCCTTAGCTGTGCTCGCGCTACTCTCTCTTTCTGGCCTGGAGGCTATCCAGCGTACTCCAAAGATTCAGGTTTACTCACGTCATCCAGCAGAGAATGGAA	Seq Percent=151%

NGATTCCTGAAGCTGACAGCATTCGGGCCGAGATATCTAGCTACGTGGACTTAGATGAGCTCGCACTAATCTCACTTTCTAGCATGGAAGCTATCCAGCGTACTCAAAAGATTAAGGTTTACTCACGTCATCGAGCAGAGAATGGA	Seq Percent=146%

GGGGCATTCCTGAAGCTGACAGCATTCGGGCCGAGATGTCTCGCTCCGTGGCCTTAGCTGTGCTCGCGCTACTCTCTCTTTCTGGCCTGGAGGCTATCCAGCGTACTCCAAAGATTCAGGTTTACTCACGTCATCCAGCAGAGAATGGAAG	Seq Percent=151%

TCCGCTCCGTGGCCTTAGCTGTGCTCGCGCTACTCTCTCTTTCTGGCCTGGAGGCTATCCAGCGTACTCCAAAGATTCAGGTTTACTCACGTCATCCAGCAGAGAATGGA	Seq Percent=110%

AGCCAAGAGGGTCATCATCTCTGCCCCCTCTGCTGATGCCCCAATGTTCGTCATGGGTGNGAACCAAGATCGGAAGAGAACAGGTATGAACTCCAGTCAAGTGTTAGTCTCGTAGGCCGTCAGATGCTTGAAAAGAAGAAACACGAAGAAA	Seq Percent=151%

NCTTAGCTGTGCTCGCGCTACTCTCTCTTTCTGGCCTGGAGGCTATCCAGTGTACTCCAAAGATTCAGGTTTACTCACGTCATCCAGCAGAGAATGGA	Seq Percent=98%

CTGCACGCCGGCCTCAACGAGCACAACCACCACCTCATCAACGACTTCACCGTCAAGCANATGAGACAAGGGGCCTTCATGGTGAACACAGCCCG	Seq Percent=95%

GCAGCTGACAGCATTCGGGCCGAGATGTCTCGCTCCGTGGCCTTAGCTGTGCTCGCGCTACTCTCTCTTTCTGGCCTGGAGGCTATCCAGCGTACTCCAAAGATTCAGGTTTACTCACGTCATCCAGCAGAGAATGGA	Seq Percent=138%

TGCTTACAGCATTCGGGCCGAGATGTCTCGCTCCGTGGCCTTAGCTGTGCTCGGGCTACTCTCTCTTTCTGGCCTGGAGGCTATCCAGCGTACTCCAAAGATTCAGGTTTACTCACGTCATCCAGCAGAGAATGGA	Seq Percent=136%

TCGGGCCTAGAGGCTATCCAGCGTACTCCAAAGATTCAGGTTGACTCACGTCATCCAGCNGAGAATGGA	Seq Percent=69%

NCTAGCCTGGAGGCTATCCAGCGTACTCCAAAGATTCAGGTTTACTCACGTCATCCAGCAGAGAATGGA	Seq Percent=69%

ATCCTGGCCTGGAGGCTGTCCAGCGTACTCCAAAGATTCAGGTTTACTCACGTCATCCAGCAGAGAATGGA	Seq Percent=71%

CTGCCCCCTCTGCTGACGCCCCCATGTTCGTCATGGGTGTGAACCA	Seq Percent=46%

TTATGGCCTGGAGGCTATCCAGCGTACTCCAAAGATTCAGGTTTACTCACGTCATCCAGCAGAGAATGGA	Seq Percent=70%

NGGGCATTCCTGAAGCTGACAGCATTCNGGCCGAGATTTCTCGCTCCGTGGCCTTAGCTGTGCTCGCGCTACTCTCTCGTTCATGCCTGGAGGCTATCCAGAGTACTATAAAGATTCAGGATTACTAACTTCATCTAGCAGAGAAAGGAAG	Seq Percent=151%

NTTTCTGGTCTGGAGGCTATCCAGCGTACTCCAAAGATTCAGGTTTACTCACGTCATCCAGCAGAGAATGGA	Seq Percent=72%

TTCTGGGCTGGAGGCTATCCAGCGTACTCCAAAGATTCAGGTTTACTCACGTCATCCAGCAGAGAATGGA	Seq Percent=70%

GCTACTCTCTCTTTCTGGCCTGGAGGCTATCCAGCGTACTCCAAAGATTCAGGTTTACTCACGTCATCCAGCAGAGAATGGA	Seq Percent=82%

CAAGTGGGCGATGCTGGCGCTGAGTACGTCGTGGAGTCCACTGGCGTCTTCACCACCATGGAGAAGGCTGGGGCTCATTTGCAGGGGGGAGCCAAAAGGGTCATCATCTCTGCCCCCTCTGCTGACGCCCCCATGTTCGTCATGGGTGTGA	Seq Percent=151%

NTTTCTGGCCTGGAGGCTATCCAGCGTACTCCAAAGATTCAGGTTTACTCACGTCATCCAGCAGAGAATGGA	Seq Percent=72%

GTCGGGCCTGGAGGCTATCCAGCGTACTCCAAAGATTCAGGTTTACTCACGTCATCCAGCAGAGAATGGA	Seq Percent=70%

GCACTAACCAACCACACCTAGCATTCCTGCACATCTGTACCCACGCCTTCTTCAAAGCCATACTATTTATGTGCTCCGGGTCCATCATCCACAACCTTAACAATGAACAAGATATCCGAAAAATAGGAGGACTACTCAAAACCATACCT	Seq Percent=149%

NACTGCCTGGAGGCTATCCAGCGTACTCCAAAGATTCAGGTTGACTCACGTCATCCAGCAGAGAATGGA	Seq Percent=69%

AAAAGGAAGAGGAGAAGAGAAAGAAAAGAAGAGAAAAAGAAAAAAAGGGAAAATGGGAGAGAAAAAAGAAAAAGAGGAAAGAAGAAGAGAAAAGGGAAGAAAAGAAGAGAATAAGAAAAAAAAAAGAAGAAGAGAAAGAAAAAGAAAAAAA	Seq Percent=151%

TGGGGCATTCCTGAAGCTGACAGCATTCGGGCCGAGATGTCTCGCTCCGTGGCCTTAGCTGTGCTCGCGCTACTCTCTCTTTCTGGCCTGGAGGCTATCCAGCGTACATGAAAGATTCANGTTTACTCACTTCATAAAGCAGAGAACGGAA	Seq Percent=151%

TCTGCGACCCTTACTTGTCGGATGGCGTGGAGCGGGCGCTGGGGCTGCAGCGTGTCAGCACCCTGCAGGACCTGCTCTTCCACAGCGACTGCGTGACCCTGCACTGCGGCCTCAACGAGCACAACCACCACCTCATCAACGACTTCACCGT	Seq Percent=151%

NTTTCTGGCCTGGAGGCTATCCAGCGTACTCCAAAGATTCAGGTTTACTCACGTCATCCAGCAGAGAATGGA	Seq Percent=72%

NATCAGCATTCGGGCCGAGATGTCTCGCTCCGTGGCCTTAGCTGTGCTCGCGCTACTCTCTCTTTCTGGCCTGGAGGCTATCCAGCGTACTCCAAAGATTCAGGTTTACTCACGTCATCCAGCAGAGAATGGA	Seq Percent=133%

CGTTCTGGCCTGGAGGCTATCCAGCGTACTCCAAAGATTCAGGTTTACTCACGTCATCCAGCAGAGAATGGA	Seq Percent=72%

AGATCCCACCAAAATCAAGTGGGGCGATGCTGGCGCTGAGTACGTCGTGGGGTCCACTGGCGTCTTCACCACCATGGAGAAGGCTGGGGCTCATTTGCAGGGGGGAGCCAAAAGGGTCATCATCTCTGCCCCCTCTGCTGACGCCCCCATG	Seq Percent=151%

TAGCTGTGCTCGCGCTACTCTCTCTTTCTGGCCTGGAGGCTATCCAGCGTACTCCAAAGATTCAGGTTTACTCACGTCATCCAGCAGAGAATGGA	Seq Percent=95%

AAAACAAGTGGGGCGATGCTGGCGCTGAGTACGTCGTGGAGTCCACTGGCGTCTTCACCACCATGGAGAAGGCTGGGGCTCATTTGCAGGGGGGAGCCAAAAGGGTCATCATCTCTGCCCCCTCTGCTGACGCCCCCATGTTCGTCATGGG	Seq Percent=151%

TGCAGAACCAGAATTTAAGGTGGAAGATGACATTTAATGGATCCTGCAGTAGTGTTTGCACATGGAAGTCCAAAAACCTGAAAGGAATATTTCAGTTCAGAGTAGTAGCTGCAAATAATCTAGGGTTTGGTGAATATAGTGGAATCAGTGA	Seq Percent=151%

TCCTGGCCTGGAGGCTATCCAGCGTACTCAAAAGATTCAGGTTTACTCACGTCATCCAGCAGAGAATGGA	Seq Percent=70%

TGGCCCGTAGGCTATCCAGCGTACTCCAAAGATTCAGGTTTACTCACGTCATCCAGCAGAGAATGGA	Seq Percent=67%

GGGCATTCCTGAAGCTGACAGCATTCGGGCCGAGATGTCTCGATCCGTGGCCTTAGCTGTGCTCGCGCTACTCTCTCTTTCTGGCCTGGAGGCTATCCAGAGTACTCCAAAGATTCAGGGTTACTCACGTCATCCAGAAGAGAATGGA	Seq Percent=148%

AGCGTGGCCTTAGCTGTGCTCGCGCTACTCTCTCCTTCTGGCCTGGAGGCTATCCAGCGTACTCCAAAGATTCAGGTTTACTCACGTCATCCAGCAGAGAATGGA	Seq Percent=105%

GGGGCATTACTGAAGCTGACAGCATTCGGGCCGAGATGTCTCGCTCCGTGGCCTTAGCTGTGCTCGCGCTACTCTCTCTTTCTGGCCTGGAGGCTATCCAGCGTACTCCAAAGATTCAGGTTTACTCACGTCATCCAGCAGAGAATGGAAG	Seq Percent=151%

NCACCACCCTGGAGAAGGCTGGGGCTCATTTGCAGGGGGGAGCCAAAAGGGTCATCATCTCTGCCCCCTCTGTTGATGCCCCCATGTTCGTCATGGGCGTGAACCA	Seq Percent=106%

GATTCCTGGAGCTGACAGCATTCGGGCCGAGATGTCTCGCTCCGTGGCCTTAGCTGTGCTCGCGCTACTCTCTCTTTCTGGCCTGGAGGCTATCCAGCGTACTCCCAAGATTCAGGTTTACTCACGTCATCCAGCAGAGAATGGA	Seq Percent=145%

ACCCATGGCAAATTCCATGGCACCGTCAAGGCTGAGAACGGGAAGCTTGTCATCAATGGAAATCCCATCACCATCTTCCAGGAGCGAGATCCCTCCAAAATCAAGTGGGGCGATGCTGGCGCTGAGTACGTCNNNGAGTCCACTGGCGTCN	Seq Percent=151%

NTTTGTGGCCTGGAGGCTATCCAGCGTACTCCAAAGATTCAGGTTTACTCACGTCATCCAGCAGAGAATGGA	Seq Percent=72%

CTTCAAAATCAAGTGGGGCGATGCTGGCGCTGAGTACGTCGTGGAGTCCACTGGCGTCTTCACCACCATGGAGAAGGCTGGGTCTCATTTGCAGGGGGTAGCCAAAAGGGTCATCCGCTCTGCCACCTCTTCTGACGCCCCCAGGTTCTT	Seq Percent=150%

GGGGCATTCCTGAAGCTGACAGCATTCGGGCCGAGATGTCTCGCTCCGTTGCCTTAGCTNTGCTCGCGCTACTCTCTCTTTCTGGCCTGGAGGCTATCCAGCGTACTCCAAAGATTCAGGTTTACTCACGTCATCCAGCAGAGAAACGAAG	Seq Percent=151%

GGGGCATTCCTGAAGCTGACAGCATTCGGGCCGAGATGTCTCGCTCCGTGGCCTTAGCTGTGCTCGCGCTACTCTCTCTTTCTGGCCTGGAGGCTATCCAGCGTACTCCAAAGATTCAGGTTTACTCACGTCATCCAGCAGAGAATGGAAG	Seq Percent=151%

GGGGCATTCCTGAAGATGACAGCATTCGGNCCGAGATGTCTCGCTCCGTGGNCNTAGNTGTGCTCGCGCTACTCTCTCTTTCTGGCATGGAGGCTATCCAGCGTACTCCAAAGATTCAGGTTTAGTCACTTCATCCAGCAGCGACTGGAAG	Seq Percent=151%

NATTCCTAGAGCTGACAGCATTCGGGCCGAGATGTCTCGCTCCGTGGCCTTAGCTGTGCTCGCGCTACTCTCTCTTTCTGGCCTGGAGGCTATCCAGCGTACTCCAAAGATTCAGGTTTACTCACGTCATCCAGCAGAGAATGGA	Seq Percent=145%

GCTTACGGATGGCGTGGAGCGGGCGCTGGGGCTGCAGCGTGTCAGCACCCTGCAGGACCTGCTCTTCCACAGCGACTGCGTGACCCTGCACTGCGGCCTCAACGAGCACAACCACCACCTCATCAACGACTTCACCGTCAAGCAGATG	Seq Percent=148%

TCACTGCGGACTCAACGAGCACAACCACCNCCNCATCAANNACNNNANNGTNAAGCANANGAGACAAGGGGCCTTCCTGGTGAACACAGCCCG	Seq Percent=93%

CGAATTCTGGCCTGGAGGCTATCCAGCGTACTCCAAAGATTCAGGTTTACTCACGTCATCCAGCAGAGAATGGA	Seq Percent=74%

CTTCTGGGCTGGAGGCTATCCAGCGTACTCCAAAGATTCAGGTTTACTCACGTCATCCAGCAGAGAATGGA	Seq Percent=71%

GGGGCCTTCCTGAAGCTGACAGCATTCGGGCCGAGATGTCTCGCTCCGTGGCCTTAGCTGTGCTCGCGCTACTCTCTCTTTCTGGCATGGAGGCTATCCAGCGTACTCCAAAGATTCAGGTTTAGTCACTTCATCCAGCAGCGACTGGAAG	Seq Percent=151%

TGATTCCTGAAGCTGACAGCATCCGGGCCGAGATGTCTCGCTCCGTGGCCTTAGCTGTGCTCGCGCTACTCTCTCTTTCTGGCCTGTAGGCTATCCAGCGTACTCCAAAGATTCAGGTTTACTCACGTCATCCAGCAGAGAATGGAAGAA	Seq Percent=150%

GGGCATTTCTGAAGCTGACAGCATTCGGGCCGAGATGTCTCGCTCCGTGGCCTTAGCTGNGCTCGCGCTACTCTCTCTTTCTGGCCTGGAGGCTATCCAGCGTACTCCAAAGATTCAGGTTTACTCACGTCATCCAGCAGAGAATGGA	Seq Percent=148%

GGGCATTTCTGAAGCTGACAGCATTCGGGCCGAGATGTCTCGCTCAGTGGCCTTAGCTGNGCTCGCGCTACTCTCTCTTTCTGGCCTGGAGGCTATCCAGCGTACTCCAAAGATTCAGGTTTACTCACGTCATCCAGCAGAGAATGGA	Seq Percent=148%

CTTTCTGGCCTGGAGGCTATCCAGCGTACTCAAAAGAATCAGGTTTACTCACGTCATCCAGCAGAGAATGGA	Seq Percent=72%

NAAATCAAGTGGGGCGATGCTGGCGCNNNGTACGTCGTGGAGTCCACTGGCGTCTTCACCACCATGGAGAAGGCTGGGGCTCATTTGCAGGGGGGAGCCAAAAGGGTCATCATCTCTGCCCCCTCTGCTGATGCCCCCATGTTCGTCATGG	Seq Percent=151%

ACTTTCTGGCCTGGAGGCTATCCAGCGTACTCCAAAGATTCAGGTTTACTCACGTCATCCAGCAGAGAATGGA	Seq Percent=73%

NTCTTTCTGGCCTGGAGGCTATCCAGNNNACTCCAAAGATTCAGGTTTACTCACGTCATCCAGCAGAGAATGGA	Seq Percent=74%

GGCCTAGAGGCTATCCAGCGTACTCCAAAGATTCAGGTTTACTCACGTCATCCAGCAGANAATGGA	Seq Percent=66%

CTGCCCCCTCTGCTGATGCCCCCATGTTCGTCATGGGTGTGAACCA	Seq Percent=46%

ATCAAGTGGGGCGATGCTGGCGCTGAGTACGTCGTGGAGTCCACTGGCGTCTTCACCACCATGGAGAAGGCTGGGGCTCATTTGCAGGGGGGAGCCAAAAGGGTCATCATCTCTGCCCCCTCTGCTGATGCCCCCATGTTCGTCATGGGTG	Seq Percent=151%

TCTCCAGCCGAGCCACATCGCTGAGACACCATGGGGAAGGTGAAGGTCGGAGTCAACGGATTTGGTCGTATTGGGCGCCTGGTCACCAGGGCTGCTTTTAACTCTGGTAAAGTGGATATTGTTGCCATCAATGACCCCTTCATTGACCTCA	Seq Percent=151%

AACTGGCCTGGAGGCTATCCAGCGTACTCCAAAGATTCAGGTTTACTCACGTCATCCAGCAGAGAATGGA	Seq Percent=70%

ATTCTGGCCTGNAGGCTATCCAGCGTACTCCAAAGATTCAGGTTTACTCACGTCATCCAGCAGAGAATGGA	Seq Percent=71%

GGATTGCCGGCCGAGCCACATCGCTGAGACACCATGGGGAAGGTGAAGGTCGGAGTCAACGGATTTGGTCGTATTGGGCGCCTGGTCACCAGGGCTGCTTTTAACTCTGGTAAAGTGGATATTGTTGCCATCAATGACCCCTTCATTGAC	Seq Percent=150%

GGGTTGCCGGCCGAGCCACATCGCTGAGACACCATGGGGAAGGTGAAGGTCGGAGTCAACGGATTTGGTCGTATTGGGCGCCTGGTCACCAGGGCTGCTTTTAACTCTGGTAAAGTGGATATTGTTGCCATCAATGACCCCTTCATTGAC	Seq Percent=150%

ACTCTGGCCTGGAGGCTATCCAGCGTACTCCAAAGATTCAGGTTTACTCACGTCATCCAGCAGAGAATGGA	Seq Percent=71%

GATTCAAGTTTACTCACGTCATCCAGCAGAGAATGGA	Seq Percent=37%

GGTCCCGGGGGATTAAAGCTGGCTATGGCACCTGCAACTGCTTCCCTGAGGAGGAGAAGTGCTTCTGCGAGCCCGAAGACATCCAGGATCCACTGTGCGACGAGCTGTGCCGCGCGGTGAT	Seq Percent=121%

CAGCAGGCCCGAGCCGCCTGGATACCGCAGCTAGGAATAATGGAATAGGACCGCGGTTCNATTTTGTTGGTTTTCGGAACTGAGGCNATGATTAAGAGAGACGGNTGGAGTG	Seq Percent=112%

CAGCAGGCCCGAGCCGCCTGGATACCGCAGCTAGGAATAATGGAATAGGACCGCGGTTCNATTTTGTTGGTTTTCGGAACTGAGGCNATGATTAAGAGAGACGGNTGGAGTG	Seq Percent=112%

NACCTTGAGGCTATCCAGCGTACTCCAAAGATTCAGGTTTACTCACGTCATCCAGCAGAGAATGGA	Seq Percent=66%

NTAGCTGTCGGATGGCGTGGAGCGGGCNNTGGGGCTGCAGCGTGTCAGCACCCTGCAGGACCTGCTCTTCCACAGCGACTGCGTGACCCTGCACTGCGGCCTCAACGAGCACAACCACCACCTCATCAACGACTTCACCGTCAAGCAGATG	Seq Percent=151%

NGTCCTAGCTGTGCTCGCGCTACTCTCTCTTTCTGGCCTGGAGGCTATCCAGCGTACTCCAAAGATTCAGGTTTACTCACGTCATCCAGCAGAGAATGGA	Seq Percent=100%

NGTCCTAGCTGTGCTCGCGCTACTCTCTCTTTCTGGCCTGGAGGCTATCCAGCGTACTCCAAAGATTCAGGTTTACTCACGTCATCCAGCAGAGAATGGA	Seq Percent=100%

TTCTGGGCCTGGAGGCTATCCAGCGTACTCCAAAGATTCAGGTTTACTCACGTCATCCAGCAGAGAATGGA	Seq Percent=71%

CACCCTGCACTTGTTGGCTTCTGACAAATGGAAAGTCCTGACACCCTTGTGATTTACTGGGATATCCTGTGGCACCTCTCCAAGTTGGTGGTCTGCCCAGACACTCATTGCTGTGNNGATGCCANNACTCTANNNTTTTCNNGNGTGGNAN	Seq Percent=151%

CATTTTCAGGGGGGAGCCAAAAGGGTCATCATCTCTGCCCCCTCTGCTGACGCCCCCATGTTCGTCATGGGTGTGAACCA	Seq Percent=80%

NGGGCATTCCTGAGGCTGACAGCATTCGGGCCGAGATGTCTCGCTCCGTGGCCTTAGCTGTGCTCGCGCTACTCTCTCTTATTGGCCTGGAGGATATCCATCGTACTCAAAAGATTCAGTTTTACTCAAGACATCCAGCAGATAATGGAAG	Seq Percent=151%

CGCTACTTGTCGGATGGCGTGGAGCGGGCGCTGGGGCTGCAGCGTGTCAGCACCCTGCAGGACCTGCTCTTCCACAGCGACTGCGTGACCCTGCACTGCGGCCTCAACGAGCACAACCGCCACCTCATCAACGACTTCACCGTCAAGC	Seq Percent=148%

GCGTGACCCTGCACTGCGGCCTCAACGAGCACAACCACCACCTCATCAACGACTTCACCGTCAAGCAGATGAGACAAGGGGCCTTCCTGGTGAACACAGCCCG	Seq Percent=103%

CCGATCATGAACGGGCCCCTGCACCCGCGGCCCCTGGTGGCATTGCTGGATGGCCGGGACTGCACAGTGGAGATGCCCATCCTGAAGGACGTGGCCACTGTGGCCTTCTGCGACGCGCAGTCCACGCAGGAGATCCATGAGAAGGTCCTGA	Seq Percent=151%

TGGCCATGGAGGCTATCCAGCGTACTCCAAAGATTCAGGTTTACTCACGTCATCCAGCAGAGAATGGA	Seq Percent=68%

CTCTGGCCCGGAGGCTATCCAGCGTACTCCAAAGATTAAGGTTTACTCACGTCATCCAGAAGAGAATGGA	Seq Percent=70%

TGAATGGCCTGGAGGCTATCCAGCGTACTCCAAAGATTCAGGTTTACTCACGTCATCCAGCAGAGAATGGA	Seq Percent=71%

TGTCTTAGCTGTGCTCGCGCTACTCTCTCTTTCTGGCCTGGAGGCTATCCAGCGTACTCCAAAGATTCAGGTTTACTCACGTCATCCAGCAGAGAATGGA	Seq Percent=100%

TTCTTGCCTGGAGGCTATCCAGCGTACTCCAAAGATTCAGGTTTACTCACGTCATCCAGCAGAGAATGGA	Seq Percent=70%

GATTCCTGGAGCTGACAGCATTCGGGCCGAGATGTCTCGCTCCGTGGCCTTAGCTGTGCTCGCGCTACTCTCTCTTTCTGGCCTGGAGGCTATCCAGCGTACTCCAAAGATTCAGGTTTACTCACGTCATCCAGCAGAGAATGGA	Seq Percent=145%

TTGGCCTGGAGGCTATCCAGCGTACTCCAAAGATTCAGGTTTACTCACGTCATCCAGCAGAGAATGGA	Seq Percent=68%

TGCACTGGGGCCTCAACGAGCACAACCACCACCTCATCAACGACTTCACCGTCAAGCAGATGAGACAAGGGGCCTTCCTGGTGAACACAGCCCG	Seq Percent=94%

GGTCTGGCCTAGAGGCTATCCAGCGTACTCCAAAGATTCAGGTTTACTCACGTCATCCAGCAGAGAATGGA	Seq Percent=71%

TTCTGGCCTGGAGGCTATCCAGCGTACTCCAAAGATTCAGGTTTACTCACGTCATCCAGCAGAGAATGGA	Seq Percent=70%

NATTTGCAGGGGGGTGCCAAAAGGGTCATCATCTCTGCCCCCTCTGCTGATGCCCCCATGTTCGTCATGGGTGTGAACCA	Seq Percent=80%

NTTTCGTGCCTGGAGGCTATCCAGCGTACTCCAAAGATTCAGGTTTACTCACGTCATCCAGCAGAGAATGGA	Seq Percent=72%

AGGACGCTTACTTGTCGGATGGCGTGGAGCGGGCGCTGGGGCTGCAGCGTGTCAGCACCCTGCAGGACCTGCTCTTCCACAGCGACCGCGTGACCCTGCACTGCGGCCTCAACGAGCACAACCACCACCTCATCAACGACTTCACCGTCAA	Seq Percent=151%

CTCGTTCTGGCCTGGAGGCTATCCAGCGTACTCCAAAGATTCAGGTTTACTCACGTCATCCAGCAGAGAATGGA	Seq Percent=74%

CGCTTTCTGGCCTGGAGGCTATCCAGCGTACTCCAAAGATTCAGGTTTACTCACGTCATCCAGCAGAGAATGGA	Seq Percent=74%

GGCATTCCCGAAGCTGACAGCATTCGGGCCGAGATGTCTCGCTCCGTGGCCTTAGCTGTGCTCGCGCTACTCTCTCTTTCTGGCCTGGAGGCTATCCAGCGTACTCCAAAGATTCAGGTTTACTAACGTCATCACGCCGCGTATCTCCT	Seq Percent=149%

GACAGCATTCGGGCCGAGATGTCTCGCTCCGTGGCCTTAGCTGTGCTCGCGCTACTCTCTCTTTCTGGCCTGGAGGCTATCCAGCGTACTCCAAAGATTCAGGTTTACTCACGTCATCCAGCAGAGAATGGA	Seq Percent=132%

AAAGCGAAGATTAGAGGTCTTGGGGCCGAAACGATCTCAACATATTCTAAAAGTTTAAATGGGTAAGAAGACCGGCTCGCTGGCGTGGAGCCGAGAGTGGAAAAAGAGTGCCTAGTGGGCCACTTTTGGTGGATGAGAAGGCGCTGAGGAA	Seq Percent=151%

TTTTCTGGCCTGGAGGCTATCCAGCGTACTCCAAAGATTCAGGTTTACTCACGTCATCCAGCAGAGAATGGA	Seq Percent=72%

AAAGGGAAAGGAGATAAAGAAAGGAAAAAGAAAATAAAAAGGAAGAGGAGGAGAAAACGAAAGAAGAAGAAAAGAAAGAGAATAAGAAGAAACAAAGGGAGGAAAAAGAGAAGAAAGAANAAAAAGAAGAAGGAGTGAGAAAAAGAACATA	Seq Percent=151%

ACAATGCTTAGACACCATGGGGAAGGTGAAGGTCGGAGTCAACGGANTTGGTCGTATTGGGCGCCTGGTCACCAGGGCTGCTTTTAACTCTGGTAAAGTGGATATTGTTGCCATCAATGACCCCTTCATTGACCTCAACTACATGGTTTAA	Seq Percent=151%

GACCCAGCACTGCGGCCTCAACGAGCACAACCACCACCTCATCAAGTAAAGCACCGTCAAGCAGATGAGAAAAGGGGCCTTCCTGGTGAACACAGACCGA	Seq Percent=100%

AATTTGCAGGGGGGAGCCAAAAGGGTCATCATCTCTGCCCCCTCTGCTGATTCCCCCATTTTCTTCATTGTTTTGAACCA	Seq Percent=80%

NCTGTGAAGCAGAATTCACCAAGCGTTGGATTGTTCACCCACTAATAGGGACCTTTAGCTGGGATTAGACCGTCGTGAGACAGGTTAGTTTTACCATACTGATGATGTGTTGTTGCCATGGTAATCCTGCTCAGTACGAGAGGAACCGCAG	Seq Percent=151%

AGCATACTCCAAAGATTCAGGTTTACTCACGTCATCCAGCAGAGAATGGA	Seq Percent=50%

GGGCTTTCCTGAAGCTGACAGCATTCGGGCCGAGATGTCTCGCTCCGTGGCCTTAGCTGTGCTCGCGCTACTCTCTCTTTCTGGCCTGGAGGCTATCCAGCGTACTCCAAAGATTCAGGTTTACTCACGTCATCCAGCAGAGAATGGA	Seq Percent=148%

CTCATTCCGGCCTGGAGGCTATACAGCGTACTCCAAAGATTCAGGTTTACTCACGTCATNCAGCAGAGAATGGA	Seq Percent=74%

>>>>>@BBBA>>EGEGGEAABF6DDF4A2BAADBAFGHH3BDDDB5BABGFADBBBBFB#ABBBBGHHHHFGHH	length=74

------------------
